Year,Department,Salary_Cost,Equipment_Cost,Maintenance_Cost,Utilities_Cost,Miscellaneous_Cost,Total_Cost
2022,Electrical,741707,470688,149283,72236,63127,1497041
2023,Mechanical,609964,467291,89297,64923,36450,1267925
2021,Civil,826118,476264,144005,51250,72999,1570636
2023,Electrical,813869,272455,138434,63264,54031,1342053
2023,Electrical,815862,385184,144749,51611,61052,1458458
2020,Mechanical,808000,307033,81607,57928,41346,1295914
2021,Computer Science,612336,492139,139183,84558,44852,1373068
2021,Civil,682212,491150,136305,50867,79882,1440416
2021,Civil,645591,439432,107973,81689,37067,1311752
2023,Computer Science,698537,463490,103117,95213,61485,1421842
2022,Computer Science,889372,413217,87645,83095,39689,1513018
2021,Computer Science,614429,356924,122238,53816,47801,1195208
2023,Mechanical,684294,282735,149694,82626,70535,1269884
2020,Mechanical,784087,322781,121773,85916,54272,1368829
2022,Civil,811979,491207,96786,97838,33763,1531573
2020,Mechanical,637310,376031,120693,61573,69696,1265303
2022,Electrical,701827,378305,106578,93334,60075,1340119
2023,Civil,799899,448713,126408,68939,58692,1502651
2019,Mechanical,807500,358049,149702,63157,56549,1434957
2022,Computer Science,699862,402783,95076,59322,30878,1287921
2020,Electrical,650255,255630,99377,52482,58848,1116592
2023,Computer Science,822603,315488,89278,85867,60741,1373977
2022,Civil,867553,384278,144808,94280,49268,1540187
2019,Computer Science,642438,306289,113539,63675,40787,1166728
2019,Mechanical,841482,268953,91440,80420,71620,1353915
2021,Mechanical,841310,350932,106245,92516,61671,1452674
2021,Civil,861084,391140,102097,61735,41336,1457392
2020,Computer Science,870013,328930,147092,63850,57738,1467623
2022,Civil,787934,436988,81151,56732,43487,1406292
2022,Computer Science,888102,251067,101698,90753,70139,1401759
2021,Electrical,807374,300658,97601,95468,64037,1365138
2022,Mechanical,827402,302165,106807,88822,42898,1368094
2022,Civil,757217,330781,125302,99720,47678,1360698
2019,Electrical,626442,390931,88039,84422,73051,1262885
2021,Electrical,681948,279164,127427,82731,48141,1219411
2023,Civil,854657,354946,138049,61428,40156,1449236
2021,Civil,887740,461985,99053,61311,54160,1564249
2023,Electrical,675791,377580,135413,53733,42835,1285352
2019,Computer Science,642406,483442,145958,89579,39383,1400768
2020,Electrical,640524,349251,111275,58342,69346,1228738
2022,Civil,754404,270773,106597,60464,54564,1246802
2019,Electrical,710160,438367,148908,98514,72013,1467962
2022,Computer Science,746836,283939,135188,95311,49225,1310499
2020,Mechanical,758635,429671,114710,60300,68484,1431800
2020,Mechanical,767442,387186,129050,84563,49946,1418187
2019,Electrical,867206,348475,129249,98960,58280,1502170
2020,Computer Science,644645,262818,114247,63708,72782,1158200
2023,Mechanical,869388,259335,106408,78090,56295,1369516
2020,Electrical,836481,489427,85443,99151,62700,1573202
2022,Electrical,857320,305008,80079,91308,77888,1411603
2022,Computer Science,685501,321745,118345,66328,65536,1257455
2022,Civil,717450,424220,92901,76654,62609,1373834
2022,Electrical,795543,253577,147759,56214,78509,1331602
2023,Civil,841605,323916,122732,88913,39751,1416917
2021,Civil,879100,385148,97507,77552,38928,1478235
2019,Mechanical,800658,413997,115391,85377,36142,1451565
2022,Civil,616709,487153,114171,75734,75955,1369722
2020,Computer Science,812330,432941,131730,74721,46257,1497979
2022,Mechanical,877354,309314,87485,68610,52650,1395413
2020,Mechanical,769746,291205,117748,63622,68181,1310502
2020,Mechanical,700025,392167,83878,78875,53212,1308157
2022,Electrical,751152,363583,81949,73226,32190,1302100
2023,Electrical,784484,334715,100881,77677,31002,1328759
2020,Civil,790043,486576,131306,60298,73945,1542168
2020,Mechanical,665480,306680,89958,85848,72882,1220848
2022,Mechanical,842840,278400,139185,83755,53038,1397218
2020,Computer Science,834622,465369,88697,67744,38094,1494526
2020,Civil,717265,494223,95493,73434,52451,1432866
2022,Computer Science,813083,357345,122801,90314,33752,1417295
2022,Civil,718922,448418,101199,98001,50521,1417061
2019,Civil,721280,337110,145792,51726,57768,1313676
2023,Electrical,804736,370120,114488,98917,58410,1446671
2023,Electrical,763522,278562,110493,64268,67206,1284051
2020,Computer Science,684433,421735,129002,96745,34427,1366342
2023,Civil,673704,268510,103731,50907,35556,1132408
2020,Mechanical,606861,311608,87076,75759,71300,1152604
2019,Electrical,838366,453561,81071,63764,48772,1485534
2022,Mechanical,663888,302182,147602,74409,58063,1246144
2022,Computer Science,661293,485699,121410,58390,69760,1396552
2022,Electrical,813596,468739,134327,80172,52709,1549543
2023,Electrical,668515,276883,141072,85223,45319,1217012
2019,Civil,869209,484981,121041,87976,35383,1598590
2023,Computer Science,768756,452499,133326,90542,31233,1476356
2023,Civil,688720,416916,118549,97324,57146,1378655
2019,Electrical,764437,399800,133096,98196,54713,1450242
2019,Computer Science,788929,479995,135578,53365,78345,1536212
2019,Electrical,736694,261094,126390,75836,73758,1273772
2019,Computer Science,841540,383479,126052,78554,44789,1474414
2022,Electrical,691141,436484,123167,71663,32930,1355385
2021,Mechanical,846476,262644,134587,55951,42112,1341770
2021,Mechanical,622995,482380,141292,65175,42374,1354216
2019,Civil,680141,335834,122139,61027,61012,1260153
2021,Mechanical,739491,358982,90707,92273,48523,1329976
2021,Electrical,764909,441818,93140,60094,54783,1414744
2019,Electrical,670799,302748,91093,73081,45563,1183284
2021,Mechanical,779949,309021,85830,62167,73193,1310160
2023,Civil,830739,312651,110608,58769,40042,1352809
2020,Mechanical,637276,286807,127287,73060,73163,1197593
2020,Computer Science,634523,415144,113427,51020,52820,1266934
2019,Computer Science,797127,419470,108395,61845,61252,1448089
2022,Computer Science,610514,278669,97970,86612,32208,1105973
2019,Mechanical,647456,411233,103371,86341,70321,1318722
2022,Mechanical,607233,388354,99266,60485,43796,1199134
2020,Mechanical,863246,276539,99195,88210,68390,1395580
2019,Computer Science,666133,384379,107315,57914,55426,1271167
2023,Civil,704085,267745,121581,90719,52670,1236800
2021,Electrical,709101,420505,125537,58802,54320,1368265
2022,Mechanical,708684,483670,102184,91288,50074,1435900
2021,Civil,694937,284555,103279,83314,57931,1224016
2021,Electrical,641548,382145,106570,98298,48993,1277554
2019,Electrical,809272,282683,123030,69565,62991,1347541
2021,Electrical,713815,275741,142245,77617,45003,1254421
2023,Civil,820994,403358,135467,91766,77496,1529081
2021,Civil,727602,253599,115133,75609,44743,1216686
2019,Computer Science,726270,378513,123805,94233,44007,1366828
2023,Civil,887714,277293,123998,70371,54300,1413676
2020,Civil,621182,265389,97238,98384,75352,1157545
2021,Civil,793691,490721,148264,69124,71282,1573082
2019,Electrical,878187,262318,128245,62717,46175,1377642
2020,Mechanical,832362,429947,103557,98193,35973,1500032
2020,Computer Science,797008,253055,145667,87669,39703,1323102
2022,Mechanical,881383,371164,145074,76272,62313,1536206
2023,Mechanical,741488,332579,138204,61842,48470,1322583
2021,Civil,734484,387392,105575,88476,59176,1375103
2019,Computer Science,624406,354817,100069,52082,53280,1184654
2022,Mechanical,864019,254642,104400,76261,53867,1353189
2023,Mechanical,809097,473766,104146,70970,70431,1528410
2022,Computer Science,758058,259321,86846,59795,51845,1215865
2023,Civil,876835,329968,120352,95309,46241,1468705
2023,Mechanical,800919,469365,103694,83028,65055,1522061
2021,Electrical,610794,440690,101740,70180,38878,1262282
2023,Mechanical,799542,352770,129438,96335,40209,1418294
2022,Electrical,747478,407116,110996,77351,58499,1401440
2023,Civil,846969,403043,143874,88750,67603,1550239
2021,Mechanical,641708,359762,139682,83268,65302,1289722
2021,Computer Science,774469,364183,124200,51015,41004,1354871
2022,Computer Science,723313,367159,102970,93293,60587,1347322
2020,Mechanical,883496,275727,90895,74489,63390,1387997
2020,Civil,836668,403631,118071,86731,58400,1503501
2023,Civil,618482,323820,132268,61866,40975,1177411
2019,Computer Science,763543,359062,102258,95015,42585,1362463
2023,Mechanical,654213,464273,137300,85474,36876,1378136
2022,Civil,875170,277476,141915,65272,78104,1437937
2022,Computer Science,838697,443755,88444,82161,43599,1496656
2022,Electrical,605435,392063,146535,52099,55239,1251371
2022,Mechanical,739565,466169,83760,56386,73906,1419786
2022,Electrical,803299,370355,116884,55338,50378,1396254
2021,Electrical,882533,320047,106022,58300,56568,1423470
2020,Civil,631498,391868,134504,71400,61510,1290780
2022,Civil,635825,253881,123130,74641,65462,1152939
2019,Civil,879078,265668,123881,54297,50688,1373612
2019,Mechanical,605574,481789,142399,69332,51796,1350890
2019,Electrical,730698,415384,116451,91173,71478,1425184
2019,Mechanical,769251,278106,131413,97862,60796,1337428
2021,Civil,642782,473830,142278,65201,50817,1374908
2019,Electrical,660561,265729,109639,95382,40061,1171372
2022,Mechanical,626751,379354,114621,96129,54401,1271256
2023,Mechanical,656572,320320,93079,83808,33810,1187589
2019,Computer Science,897345,304913,86895,62810,63680,1415643
2021,Mechanical,636069,438098,132142,57988,53826,1318123
2021,Civil,813262,309402,92552,90327,34902,1340445
2019,Mechanical,888514,371649,128821,69579,49612,1508175
2023,Electrical,826090,353930,113630,71483,79723,1444856
2019,Mechanical,858245,418354,92247,50503,40663,1460012
2021,Computer Science,781303,480521,97603,55344,43967,1458738
2020,Electrical,679468,455710,125564,58947,77776,1397465
2022,Electrical,760371,490874,80527,59533,70536,1461841
2021,Computer Science,690715,419290,136521,97576,35135,1379237
2019,Civil,670793,399022,148458,90916,44072,1353261
2022,Electrical,788206,309739,85849,96923,71057,1351774
2019,Civil,711672,498765,130314,65193,50417,1456361
2019,Electrical,742321,254507,125724,51381,36443,1210376
2020,Electrical,720902,427375,97230,57012,67610,1370129
2022,Civil,621390,352552,122730,65213,51925,1213810
2022,Electrical,620369,329059,83323,77563,60002,1170316
2020,Civil,743953,405739,80445,65212,66795,1362144
2021,Computer Science,871731,385064,89963,80124,60993,1487875
2019,Civil,824872,487898,130511,96576,30260,1570117
2023,Computer Science,838634,380514,95437,60711,39127,1414423
2019,Electrical,647013,454635,96855,80266,79483,1358252
2019,Civil,717341,337680,90847,97941,66978,1310787
2021,Electrical,794692,275530,83236,59515,54843,1267816
2019,Civil,746826,491348,141897,70193,62840,1513104
2020,Computer Science,707584,265305,93487,94707,67879,1228962
2020,Computer Science,678113,359097,142423,52131,32921,1264685
2022,Civil,635282,433201,93155,52424,73413,1287475
2023,Computer Science,767809,468339,91255,94344,33888,1455635
2019,Electrical,886268,467281,81979,71823,30177,1537528
2019,Electrical,696651,479905,101305,59200,37426,1374487
2021,Mechanical,846549,302044,115094,73031,34495,1371213
2020,Computer Science,685395,472450,115098,53216,63037,1389196
2023,Electrical,611345,380436,113770,95594,40047,1241192
2022,Civil,896221,339363,89734,50016,48039,1423373
2020,Computer Science,797472,308817,119605,87438,65301,1378633
2022,Electrical,612055,353038,135619,76378,78707,1255797
2021,Computer Science,685283,296666,107881,85391,75114,1250335
2021,Civil,644484,407245,143401,81734,51366,1328230
2019,Electrical,677514,268909,111177,63350,50745,1171695
2023,Mechanical,690135,445039,120122,99281,73082,1427659
2022,Mechanical,897915,412079,115297,64450,41353,1531094
2020,Computer Science,788726,394057,116680,51473,55080,1406016
2021,Civil,814223,499521,131044,75525,48788,1569101
2019,Electrical,717399,272525,124084,78572,64969,1257549
2019,Civil,780645,362293,114189,92028,35659,1384814
2022,Electrical,773805,351046,93510,87079,63921,1369361
2021,Computer Science,729344,287403,102152,80110,34161,1233170
2023,Electrical,742832,418265,106445,85504,45503,1398549
2021,Civil,713226,488037,81195,76888,57003,1416349
2022,Civil,699250,384902,139949,51946,54982,1331029
2022,Computer Science,887906,437216,105433,71943,33478,1535976
2021,Civil,782058,381605,85305,65740,58620,1373328
2022,Electrical,765404,493626,138860,76445,79428,1553763
2021,Computer Science,771172,402018,128648,99452,65129,1466419
2020,Electrical,736016,273504,143090,59176,57172,1268958
2021,Civil,648825,360551,122113,79866,40160,1251515
2021,Computer Science,613877,305715,122642,94651,65214,1202099
2022,Electrical,729065,409327,113062,87269,41931,1380654
2022,Civil,708443,437513,121604,61618,61170,1390348
2019,Civil,717674,286855,86678,74736,61190,1227133
2019,Mechanical,715074,291721,112121,88682,37601,1245199
2020,Civil,851881,361597,128503,74601,67819,1484401
2019,Electrical,631629,422922,96494,82850,33517,1267412
2021,Computer Science,754030,350659,124185,91132,34802,1354808
2022,Mechanical,877919,284723,89678,55804,75158,1383282
2019,Civil,765279,416811,117632,69525,48759,1418006
2019,Civil,862199,255539,126235,95061,37850,1376884
2020,Civil,849084,454101,81648,77419,36744,1498996
2020,Electrical,688697,445581,147917,73746,52773,1408714
2021,Mechanical,763945,366360,96489,62812,78185,1367791
2022,Electrical,701505,351140,85818,76686,36248,1251397
2020,Mechanical,797277,402383,113149,85852,78196,1476857
2019,Computer Science,756390,484315,107312,52045,37136,1437198
2022,Electrical,633734,319180,117124,75336,72285,1217659
2022,Electrical,813299,366985,81316,99356,41800,1402756
2019,Computer Science,749594,335981,140046,95952,43417,1364990
2020,Mechanical,742728,285934,149610,80460,55305,1314037
2019,Civil,746965,390583,144042,97143,66735,1445468
2022,Computer Science,878637,381255,103102,71668,75129,1509791
2023,Civil,695872,259475,111957,84320,67719,1219343
2023,Civil,769524,465838,92872,90584,34002,1452820
2021,Computer Science,744338,444202,130094,82575,32332,1433541
2019,Mechanical,716603,309577,127719,83592,56149,1293640
2019,Civil,616940,276008,99693,86516,74228,1153385
2021,Computer Science,755075,457940,130478,55578,34375,1433446
2021,Electrical,727880,429013,123677,87965,59458,1427993
2021,Electrical,698408,292756,140012,91798,63453,1286427
2022,Electrical,896959,451330,90760,71079,50272,1560400
2019,Computer Science,761941,330730,91584,50937,47352,1282544
2022,Electrical,649297,473239,82106,57595,32033,1294270
2021,Civil,660107,408984,93669,50424,69843,1283027
2019,Electrical,619622,332702,105223,94270,51645,1203462
2022,Electrical,892552,431731,140666,53051,55343,1573343
2022,Civil,739909,296840,115706,85673,77415,1315543
2021,Electrical,746479,462584,148019,81342,30645,1469069
2019,Civil,760381,288623,141585,62238,61775,1314602
2021,Electrical,693190,313303,107482,77786,34121,1225882
2019,Civil,852356,296062,140369,79668,38112,1406567
2023,Electrical,817984,306690,114143,52694,39271,1330782
2020,Civil,600370,458654,104240,53595,69204,1286063
2020,Computer Science,862630,348980,90015,51267,55212,1408104
2020,Civil,885906,404706,143023,50421,75285,1559341
2021,Electrical,626613,385162,131500,69650,40292,1253217
2023,Electrical,843876,295266,143925,57017,53481,1393565
2019,Mechanical,603196,411080,129631,59849,71060,1274816
2022,Civil,826009,337643,143652,73513,68354,1449171
2019,Computer Science,608572,308704,131087,99117,58493,1205973
2022,Civil,645853,492153,134909,94899,59475,1427289
2019,Civil,763347,443938,91565,91644,30868,1421362
2023,Computer Science,716074,367374,107597,52226,77370,1320641
2022,Civil,643209,258382,145623,54388,68682,1170284
2021,Computer Science,694244,428846,89432,52422,38213,1303157
2019,Computer Science,832067,455642,145714,89994,52739,1576156
2019,Civil,853516,455134,129314,59269,31903,1529136
2022,Civil,808472,339609,121965,62177,65344,1397567
2021,Electrical,700300,296698,147957,62032,77491,1284478
2021,Electrical,798033,251110,123715,94276,66877,1334011
2023,Mechanical,657175,365266,133450,57316,50998,1264205
2021,Mechanical,701551,463053,141902,52843,48319,1407668
2021,Civil,881120,381458,108317,78015,63383,1512293
2021,Computer Science,846984,439585,146753,54111,51441,1538874
2020,Mechanical,656866,465192,115242,95231,40642,1373173
2023,Civil,717752,492282,80929,72043,41776,1404782
2019,Mechanical,853564,481059,93580,80101,54862,1563166
2022,Computer Science,893257,297801,100742,96546,61103,1449449
2019,Civil,846592,364012,97833,86992,41510,1436939
2023,Computer Science,615401,346085,93527,77870,64691,1197574
2022,Civil,815432,452929,138139,87747,43402,1537649
2023,Mechanical,765486,471048,149585,99577,36455,1522151
2021,Electrical,747214,281566,121057,85169,70372,1305378
2022,Mechanical,846200,488054,147439,91709,70920,1644322
2021,Mechanical,810536,413593,124261,79415,32773,1460578
2019,Electrical,806329,491300,80042,65685,73050,1516406
2019,Electrical,676693,273798,102769,65963,57377,1176600
2022,Civil,635135,394637,147113,79698,39776,1296359
2022,Civil,890006,273027,102449,79150,62059,1406691
2023,Computer Science,736262,488108,118653,99195,59405,1501623
2023,Computer Science,670199,478703,108859,71426,30143,1359330
2021,Mechanical,604331,255631,88576,56035,55698,1060271
2022,Electrical,783258,470937,125874,57071,47083,1484223
2019,Computer Science,890693,489628,116345,70578,75169,1642413
2023,Mechanical,812854,306878,149428,78044,52702,1399906
2023,Electrical,625761,295206,84321,78842,63038,1147168
2019,Civil,865406,353473,85776,66531,71022,1442208
2023,Mechanical,855792,439654,96119,52170,31007,1474742
2021,Civil,784544,308334,110569,74687,57419,1335553
2022,Computer Science,684667,322323,118596,87886,76483,1289955
2019,Computer Science,604677,303619,132967,57297,73232,1171792
2022,Electrical,804580,353536,113063,54163,40174,1365516
2023,Mechanical,730334,407947,102340,90794,60880,1392295
2023,Civil,660148,405586,135430,91787,37203,1330154
2019,Electrical,675271,403652,86668,92712,66492,1324795
2021,Computer Science,634457,466899,88195,85707,58989,1334247
2020,Computer Science,642531,385360,137995,88495,57331,1311712
2019,Mechanical,804335,256734,118250,94688,74694,1348701
2020,Civil,728027,464072,96076,74448,52983,1415606
2020,Mechanical,794243,289008,95376,53616,59735,1291978
2021,Civil,857231,299349,135839,88173,70685,1451277
2020,Civil,849301,388886,144723,81748,50893,1515551
2020,Mechanical,645771,424226,123442,78299,45739,1317477
2021,Electrical,693135,388923,85392,93237,59917,1320604
2020,Mechanical,666354,374478,107106,91119,50704,1289761
2020,Mechanical,712743,382672,104809,61557,60152,1321933
2020,Computer Science,844453,306614,80693,88648,77383,1397791
2019,Computer Science,633892,453474,139821,64096,68240,1359523
2019,Mechanical,802268,253692,91352,83781,37206,1268299
2019,Mechanical,695057,376745,132196,58743,53256,1315997
2021,Computer Science,638409,439099,84992,57391,54307,1274198
2023,Civil,846889,498843,133076,59355,34716,1572879
2020,Mechanical,749457,270373,103354,55247,65388,1243819
2020,Electrical,626382,479708,83312,90286,48920,1328608
2021,Electrical,676675,493085,125833,56290,67871,1419754
2020,Electrical,622419,443877,84318,84076,72928,1307618
2019,Mechanical,681238,362413,146003,92452,53464,1335570
2023,Civil,825825,461455,107192,75817,68085,1538374
2022,Civil,770363,264507,117489,95491,43587,1291437
2020,Computer Science,874541,312931,120309,87595,31195,1426571
2019,Mechanical,635169,325499,108273,82827,55083,1206851
2022,Civil,662182,452714,127553,76209,79556,1398214
2023,Mechanical,759413,453941,109473,89754,52438,1465019
2022,Computer Science,777216,364362,141410,82118,50009,1415115
2019,Computer Science,679360,347449,93679,93411,70636,1284535
2022,Computer Science,613444,346819,125310,65216,65587,1216376
2021,Electrical,723662,289423,140683,57860,51143,1262771
2022,Mechanical,845488,353612,105992,63425,43696,1412213
2020,Computer Science,698843,476423,109433,63806,37564,1386069
2020,Mechanical,873118,336120,105933,97718,33637,1446526
2021,Electrical,712150,367409,125020,74911,64641,1344131
2019,Electrical,856620,340918,109236,75406,47790,1429970
2020,Computer Science,694826,316600,138735,84360,58159,1292680
2023,Computer Science,825121,291848,89770,64464,35514,1306717
2020,Civil,898634,490491,149285,80587,64345,1683342
2020,Mechanical,841435,256820,115271,88865,51763,1354154
2019,Computer Science,724713,258512,103439,56458,42568,1185690
2022,Civil,655612,417797,91101,59151,58003,1281664
2020,Mechanical,700474,301534,124917,86934,35311,1249170
2021,Computer Science,898303,466223,121196,56488,71596,1613806
2022,Civil,639710,375191,103569,74541,68315,1261326
2023,Civil,713096,420848,121887,71803,47191,1374825
2019,Mechanical,809417,310945,100893,93183,50908,1365346
2023,Civil,811463,495420,135304,94776,31415,1568378
2022,Mechanical,694924,333420,112399,74718,70276,1285737
2022,Mechanical,868602,428527,105236,61170,77650,1541185
2022,Mechanical,897668,333488,129531,67430,48833,1476950
2023,Electrical,737925,433505,89442,97284,45406,1403562
2022,Civil,894366,259711,136437,59260,59336,1409110
2023,Mechanical,618320,440334,140342,57636,59421,1316053
2022,Computer Science,694154,336009,115069,86955,66264,1298451
2021,Electrical,652243,464857,118560,86108,41780,1363548
2022,Electrical,776687,259597,138070,88945,69871,1333170
2023,Civil,672833,310067,122427,65941,42221,1213489
2020,Mechanical,693476,468592,140496,53435,51116,1407115
2022,Civil,714560,298022,144557,78355,69790,1305284
2020,Electrical,637941,462996,128534,57300,70263,1357034
2021,Mechanical,625368,362673,107930,95437,44422,1235830
2019,Computer Science,893128,487335,87288,72183,71474,1611408
2021,Mechanical,803990,496928,141518,83733,51483,1577652
2022,Electrical,857481,399854,112400,57444,70100,1497279
2020,Computer Science,600801,301782,81567,75755,35416,1095321
2020,Mechanical,706538,453216,127878,93394,45251,1426277
2023,Computer Science,685269,479723,128850,73062,57074,1423978
2020,Computer Science,853765,436085,81094,64610,76540,1512094
2023,Electrical,898113,360716,91135,50500,42164,1442628
2019,Computer Science,691679,489381,125113,54554,32468,1393195
2022,Civil,756777,368030,138791,99201,73655,1436454
2023,Electrical,791375,322036,89684,75545,32027,1310667
2019,Civil,890507,285342,138552,96059,53555,1464015
2020,Computer Science,761792,335745,88046,56771,41944,1284298
2020,Civil,633351,402049,84934,67499,30315,1218148
2019,Mechanical,711023,484648,139556,53932,44133,1433292
2020,Computer Science,767217,307396,126806,76055,66757,1344231
2019,Mechanical,687948,364836,81354,87202,63298,1284638
2023,Civil,820686,356998,133046,77700,54268,1442698
2023,Mechanical,819188,300021,145064,53567,73362,1391202
2019,Computer Science,876999,450129,137184,51658,34757,1550727
2023,Mechanical,861677,380672,82963,92836,70640,1488788
2023,Civil,777476,368559,107424,96929,78266,1428654
2023,Civil,750641,316836,83042,90712,59967,1301198
2021,Civil,725074,408147,87139,76627,55795,1352782
2022,Computer Science,860078,470587,91226,88568,58798,1569257
2020,Civil,654437,411874,118108,70760,72726,1327905
2021,Computer Science,756810,458833,148617,79985,63835,1508080
2023,Mechanical,690410,327017,109815,64408,61461,1253111
2019,Civil,619731,467825,87802,79832,63495,1318685
2023,Mechanical,741203,491421,122230,90785,46627,1492266
2022,Electrical,785169,436894,143372,85583,56361,1507379
2023,Mechanical,865033,432675,134020,83738,30711,1546177
2019,Electrical,609569,352689,97465,74204,41085,1175012
2022,Mechanical,806749,330291,87994,63285,57726,1346045
2023,Computer Science,685192,340450,83531,82975,37924,1230072
2022,Mechanical,854829,416664,89343,66643,45549,1473028
2020,Computer Science,687154,306006,139066,55025,38462,1225713
2020,Computer Science,808542,407341,86229,87126,72757,1461995
2023,Civil,708073,354268,124789,66888,32560,1286578
2022,Computer Science,819894,300138,124069,95258,51523,1390882
2019,Electrical,869756,312398,89524,84527,49944,1406149
2023,Civil,651644,471163,143103,73898,32177,1371985
2020,Civil,632069,400946,88103,97069,79989,1298176
2020,Mechanical,745006,307228,138581,64387,50098,1305300
2023,Computer Science,618706,312670,134203,96435,65846,1227860
2022,Computer Science,774588,375613,95090,53794,57475,1356560
2020,Electrical,703602,352071,95915,53590,72736,1277914
2022,Mechanical,896773,492952,121477,64698,62447,1638347
2020,Mechanical,724746,360572,136987,62332,51416,1336053
2020,Civil,620431,497766,133238,89738,44120,1385293
2021,Civil,787805,388997,95029,59593,32948,1364372
2020,Civil,640088,253107,133520,80107,32520,1139342
2019,Electrical,775207,336388,131464,81490,37269,1361818
2023,Electrical,831110,345719,101961,86097,56961,1421848
2023,Civil,631385,368018,106835,61036,43336,1210610
2022,Mechanical,718104,277617,107725,78561,75198,1257205
2020,Electrical,612818,324258,105357,64372,44020,1150825
2019,Mechanical,755049,300075,81244,84860,57280,1278508
2022,Mechanical,649832,376998,147952,69351,73478,1317611
2021,Computer Science,683990,272631,128061,80327,46746,1211755
2022,Civil,809966,373120,86490,68059,32256,1369891
2022,Computer Science,672204,443516,85839,77188,70120,1348867
2020,Civil,645784,347158,104992,83055,57712,1238701
2021,Civil,609921,497656,124938,99937,42836,1375288
2022,Mechanical,897103,388955,136249,52316,55711,1530334
2019,Civil,894472,400780,124735,66259,34358,1520604
2019,Mechanical,855564,296221,130734,85606,41339,1409464
2023,Mechanical,689506,398269,127080,61829,62039,1338723
2021,Civil,674408,402206,104260,58137,51245,1290256
2021,Mechanical,723852,355922,139607,74502,77251,1371134
2023,Mechanical,815838,283550,141852,77204,47259,1365703
2022,Mechanical,626708,264642,108380,51265,37129,1088124
2021,Electrical,618847,401511,121191,85751,78789,1306089
2019,Mechanical,655989,478851,84930,72285,72112,1364167
2019,Electrical,604922,356093,84353,74315,70573,1190256
2020,Electrical,652335,405655,87832,97457,71588,1314867
2021,Mechanical,881695,343885,129554,96875,41211,1493220
2022,Mechanical,750453,329538,134017,90911,60197,1365116
2023,Electrical,622948,312014,137298,90798,45628,1208686
2023,Electrical,692264,269523,131389,95890,56300,1245366
2022,Mechanical,659072,360285,105525,93420,75708,1294010
2020,Mechanical,813321,451615,148211,83379,77092,1573618
2023,Civil,733558,467043,111280,86291,47512,1445684
2021,Electrical,666691,355879,91240,77152,50945,1241907
2020,Electrical,741154,340629,145092,55424,71723,1354022
2021,Civil,607086,498950,149541,59939,63787,1379303
2019,Electrical,667853,495560,142851,80253,51408,1437925
2020,Computer Science,878060,326830,86544,84396,78408,1454238
2023,Electrical,877392,485013,137981,63176,50311,1613873
2020,Civil,886370,295538,97332,57907,65609,1402756
2020,Computer Science,838922,297310,106836,53372,41139,1337579
2020,Mechanical,648380,391980,94388,77572,68245,1280565
2020,Civil,869992,365266,81694,74592,71634,1463178
2021,Civil,614274,438362,129294,63102,47610,1292642
2019,Mechanical,860115,434706,118769,92557,58952,1565099
2022,Civil,696494,262699,119420,75642,43568,1197823
2020,Electrical,715981,481241,117855,53139,54899,1423115
2023,Mechanical,766305,316912,81460,61643,73798,1300118
2020,Civil,616304,395327,127646,68643,42002,1249922
2023,Mechanical,873438,329183,121252,85018,37529,1446420
2021,Mechanical,888569,310282,89835,88889,48069,1425644
2023,Mechanical,799783,308249,90910,78780,78478,1356200
2022,Computer Science,710777,288176,88463,90949,33712,1212077
2019,Civil,691549,258163,93336,98071,69826,1210945
2023,Computer Science,693464,304210,106534,66667,49328,1220203
2023,Civil,706748,373844,82369,80632,47711,1291304
2019,Electrical,878235,354587,105381,88493,35906,1462602
2022,Electrical,854174,481352,105407,98352,59107,1598392
2020,Electrical,731074,321979,142552,79408,47813,1322826
2023,Civil,853890,328860,115939,74302,39153,1412144
2019,Mechanical,650411,402215,147576,71621,76213,1348036
2021,Mechanical,858901,486971,106170,63219,61679,1576940
2019,Computer Science,695696,254920,102369,91562,59588,1204135
2021,Computer Science,751779,497647,124544,75939,78096,1528005
2022,Electrical,746320,332911,85900,96880,53770,1315781
2020,Computer Science,671309,287996,120733,94312,48852,1223202
2019,Civil,809394,392820,80589,86843,77422,1447068
2023,Civil,746109,344071,140044,62778,49612,1342614
2022,Computer Science,667421,462323,145311,88930,60907,1424892
2019,Computer Science,836436,297252,137926,79870,60171,1411655
2023,Computer Science,613450,372734,129008,90404,45448,1251044
2019,Computer Science,609491,444251,146794,72121,33966,1306623
2021,Electrical,717026,387522,82866,90770,71876,1350060
2019,Electrical,674804,302756,132890,96221,51401,1258072
2019,Computer Science,719498,300235,121504,80158,51539,1272934
2019,Civil,838515,340546,133374,73456,64018,1449909
2022,Electrical,890458,381092,109404,97401,34688,1513043
2019,Civil,796701,375802,145223,62992,50457,1431175
2023,Mechanical,842223,461325,80637,94894,66555,1545634
2021,Civil,609967,493956,95828,75390,71899,1347040
2021,Computer Science,812826,358421,133544,95858,61379,1462028
2019,Mechanical,805235,390736,125097,66756,40470,1428294
2022,Electrical,770491,316635,112022,71971,68426,1339545
2022,Electrical,628876,273225,112202,57071,39193,1110567
2023,Mechanical,819516,449245,108704,77574,64980,1520019
2019,Civil,751043,356885,103641,96517,69635,1377721
2021,Electrical,829192,487120,117479,69275,69731,1572797
2022,Computer Science,854767,335333,102027,94751,52077,1438955
2019,Mechanical,852313,421297,122912,56586,74097,1527205
2022,Computer Science,628261,260807,122692,69703,66759,1148222
2022,Mechanical,706601,464346,112209,76765,39295,1399216
2021,Electrical,661260,256402,137563,60641,44735,1160601
2020,Civil,656176,254521,136738,86735,77011,1211181
2023,Mechanical,742412,444237,117242,50822,75185,1429898
2023,Mechanical,895156,364693,89941,82989,33032,1465811
2021,Computer Science,766465,258382,87073,89648,73773,1275341
2022,Electrical,702153,360996,117827,62129,66671,1309776
2019,Computer Science,748348,483729,126225,65543,75019,1498864
2022,Electrical,607310,265065,117096,75963,59897,1125331
2021,Computer Science,766239,335470,130546,86656,55836,1374747
2023,Mechanical,741463,264425,146457,79665,66438,1298448
2022,Computer Science,722013,263111,148309,63499,51278,1248210
2023,Civil,781693,421871,149998,60352,51902,1465816
2019,Electrical,741964,303257,110268,69654,66091,1291234
2023,Electrical,809658,373990,122078,60117,37120,1402963
2023,Mechanical,772687,442249,81865,71077,37859,1405737
2020,Electrical,778625,377813,108887,95540,62867,1423732
2020,Civil,709264,331046,129876,53993,60611,1284790
2020,Computer Science,679071,287851,113479,68982,66424,1215807
2023,Mechanical,772074,258816,120478,84434,75477,1311279
2021,Civil,670658,458925,106401,66312,36786,1339082
2023,Electrical,609852,252175,108502,94041,63461,1128031
2021,Electrical,867531,261341,93394,64338,51185,1337789
2021,Civil,730381,313908,89262,80173,70977,1284701
2020,Computer Science,834484,406726,84487,87525,61190,1474412
2022,Computer Science,803754,441967,107341,76690,33709,1463461
2019,Mechanical,731632,309696,93570,77328,49154,1261380
2020,Electrical,863456,438961,137268,61360,50859,1551904
2020,Civil,687566,468216,109605,88883,77611,1431881
2022,Computer Science,883473,333115,106723,88205,34209,1445725
2019,Mechanical,834750,280194,149108,72625,53379,1390056
2023,Electrical,675542,415909,140098,92040,44846,1368435
2023,Electrical,708237,449966,128707,94894,48003,1429807
2020,Mechanical,897789,334358,129028,81850,55426,1498451
2019,Mechanical,687502,422648,136921,66471,72856,1386398
2020,Computer Science,895657,352548,140760,89883,55551,1534399
2021,Civil,608749,400799,90249,77276,48900,1225973
2020,Electrical,761855,284579,147847,52703,42380,1289364
2020,Civil,660645,346554,123839,61151,39707,1231896
2023,Electrical,813933,397627,119673,76998,54379,1462610
2023,Electrical,653175,303294,83642,54147,55068,1149326
2023,Civil,748395,299777,86338,84515,36906,1255931
2021,Mechanical,650762,386978,131761,58232,45895,1273628
2023,Computer Science,664222,290751,89622,65151,49420,1159166
2019,Electrical,789400,450671,128423,60330,45212,1474036
2022,Mechanical,855539,358750,122873,99190,44323,1480675
2019,Electrical,612213,324180,127565,61276,62934,1188168
2019,Computer Science,697367,488986,87806,68535,37348,1380042
2023,Electrical,778002,454750,80757,86705,30575,1430789
2022,Computer Science,758785,281644,101470,89654,69939,1301492
2022,Computer Science,707157,283521,86220,93050,45748,1215696
2022,Electrical,829408,261564,134754,82976,33343,1342045
2021,Electrical,632583,355155,102505,50599,72115,1212957
2023,Computer Science,728792,451712,108288,53709,55391,1397892
2022,Mechanical,679944,408371,99109,74110,52407,1313941
2021,Civil,622369,429030,83497,99365,72495,1306756
2020,Computer Science,779000,437150,137326,55723,73693,1482892
2020,Electrical,619510,394493,89864,96772,70747,1271386
2021,Electrical,612120,338747,101017,92536,39154,1183574
2021,Mechanical,699847,261202,81821,77394,51555,1171819
2023,Civil,698575,359407,130337,60316,56623,1305258
2023,Computer Science,867439,423257,125485,72622,68177,1556980
2020,Computer Science,620460,487735,136388,74844,67309,1386736
2022,Civil,614963,384757,90372,90740,50244,1231076
2020,Computer Science,627328,340197,96283,71162,57927,1192897
2022,Civil,724034,292637,120857,78833,31067,1247428
2022,Electrical,621605,399438,131772,67206,47265,1267286
2023,Civil,775885,484320,139670,74501,36909,1511285
2019,Computer Science,777443,274276,111261,98314,51416,1312710
2019,Civil,708241,330946,137154,60291,44236,1280868
2021,Mechanical,791848,429311,86107,94562,61365,1463193
2023,Electrical,854289,325214,115561,61659,56125,1412848
2022,Electrical,767984,405647,115268,75226,40929,1405054
2019,Civil,769446,422473,111608,90751,71060,1465338
2022,Computer Science,803374,291230,93138,56500,61411,1305653
2019,Mechanical,662784,460496,117693,51634,45319,1337926
2019,Electrical,621274,463335,101248,64059,65584,1315500
2019,Electrical,729994,374086,98632,54814,36411,1293937
2023,Computer Science,896560,379526,127547,54076,61602,1519311
2020,Computer Science,817220,495579,92100,91158,78489,1574546
2022,Mechanical,792070,449689,127930,88210,79559,1537458
2023,Civil,843768,404093,146861,75931,37204,1507857
2023,Computer Science,768206,390521,133025,82007,48899,1422658
2023,Civil,743435,396729,130840,72744,54517,1398265
2023,Mechanical,892772,285059,99369,80396,64507,1422103
2023,Civil,669672,251532,98460,73083,34052,1126799
2021,Electrical,646246,352666,81461,86273,79410,1246056
2022,Civil,689110,431877,122362,99954,68554,1411857
2023,Mechanical,864954,331551,108610,75276,42013,1422404
2022,Mechanical,790932,418828,100995,50502,75364,1436621
2021,Mechanical,808271,321880,87717,62756,67488,1348112
2021,Civil,671688,356734,144022,64262,77213,1313919
2022,Electrical,793435,363997,133668,98909,66494,1456503
2019,Computer Science,873306,455714,131645,60605,30678,1551948
2020,Electrical,673535,415278,109550,90707,60352,1349422
2019,Civil,670864,302168,83576,72416,75797,1204821
2019,Civil,734693,363123,120868,87487,39098,1345269
2019,Computer Science,718371,456260,126380,90516,38459,1429986
2023,Civil,689792,405622,85728,77543,68894,1327579
2021,Mechanical,775505,387461,112800,81280,57679,1414725
2019,Mechanical,857416,337897,90886,52870,62666,1401735
2021,Mechanical,666188,416919,149909,54758,43227,1331001
2022,Mechanical,786023,354599,127236,95806,34906,1398570
2020,Mechanical,838188,329239,125805,88736,37898,1419866
2022,Civil,636558,268642,112532,61659,77207,1156598
2022,Computer Science,728938,356862,108688,99534,63884,1357906
2023,Computer Science,746731,498751,91063,90558,36344,1463447
2020,Mechanical,896557,286509,103089,59585,71858,1417598
2022,Civil,872579,329417,135942,77903,57366,1473207
2022,Electrical,850272,299237,131829,87039,75980,1444357
2020,Electrical,628067,396486,130553,54323,76846,1286275
2020,Civil,687794,313176,113585,76970,40836,1232361
2022,Mechanical,601379,378633,139004,84806,47442,1251264
2020,Computer Science,708541,329865,82438,98745,79839,1299428
2022,Civil,819499,367181,103212,55461,70920,1416273
2022,Electrical,714634,312059,130362,90831,71747,1319633
2023,Electrical,853579,299150,96983,84030,42686,1376428
2019,Electrical,703915,338367,94026,55731,73604,1265643
2022,Mechanical,810494,291091,130998,71500,40356,1344439
2021,Electrical,816915,454196,135744,59903,71163,1537921
2019,Civil,729560,250903,137013,83117,57793,1258386
2019,Civil,755915,491024,131039,78602,32491,1489071
2019,Electrical,736984,304235,129831,81174,51206,1303430
2023,Civil,752586,439637,114603,83208,43928,1433962
2022,Electrical,818431,305342,147713,69192,69772,1410450
2023,Electrical,788104,423795,93105,63899,41560,1410463
2022,Computer Science,737521,285572,147182,68946,37011,1276232
2023,Mechanical,732797,267610,132147,53152,52084,1237790
2023,Mechanical,609304,284052,126434,75960,74518,1170268
2021,Computer Science,725555,348993,106515,60247,58633,1299943
2023,Computer Science,694488,337063,138001,80806,34862,1285220
2020,Mechanical,858490,418622,138397,75573,68118,1559200
2021,Electrical,743748,435105,141415,92382,42682,1455332
2023,Electrical,887336,410083,96960,99225,75303,1568907
2019,Mechanical,861602,483883,125778,76038,41703,1589004
2020,Electrical,738518,415836,110941,77770,72379,1415444
2020,Computer Science,816669,347540,120955,56949,45096,1387209
2020,Electrical,688207,303533,136908,52205,44106,1224959
2021,Electrical,788704,405136,144067,67855,30355,1436117
2023,Civil,798017,373989,135696,69564,38432,1415698
2023,Civil,673741,430653,98429,63133,45700,1311656
2019,Civil,616365,370388,94847,68114,55196,1204910
2019,Electrical,795929,278702,127191,82803,61650,1346275
2020,Mechanical,847481,466773,114256,79785,76618,1584913
2019,Computer Science,746776,373482,108774,88302,47238,1364572
2021,Electrical,760974,258631,89127,73545,74703,1256980
2023,Mechanical,832366,337388,108205,90777,57776,1426512
2020,Electrical,850319,374798,138764,60952,36704,1461537
2019,Computer Science,634012,320043,118664,52535,50008,1175262
2021,Electrical,742487,447135,136795,74721,45379,1446517
2021,Computer Science,621686,410053,112333,54963,72020,1271055
2019,Electrical,808270,285764,116079,62707,38573,1311393
2023,Computer Science,759815,482843,104259,62860,52415,1462192
2019,Electrical,632161,431585,106571,64247,52566,1287130
2020,Computer Science,847066,379014,131119,67410,31132,1455741
2019,Civil,839689,363076,88009,67670,78302,1436746
2021,Electrical,864546,349007,141829,69230,73798,1498410
2019,Electrical,663190,447270,118230,91280,64847,1384817
2023,Mechanical,846256,274940,136049,74158,30944,1362347
2022,Mechanical,875419,357418,116498,63887,35840,1449062
2019,Computer Science,759254,321792,108820,85061,69442,1344369
2023,Electrical,614915,409504,120315,99628,73489,1317851
2023,Computer Science,863053,258367,112795,73810,75261,1383286
2021,Civil,665908,361764,119191,94124,74278,1315265
2023,Mechanical,727337,484673,134453,92786,63602,1502851
2023,Computer Science,884764,406583,92453,75358,50134,1509292
2023,Computer Science,634112,258573,130325,95588,34184,1152782
2023,Mechanical,805123,265582,129490,65933,57963,1324091
2020,Electrical,602431,386450,129993,80034,37178,1236086
2020,Computer Science,686590,315296,125706,51947,35168,1214707
2021,Mechanical,717472,394572,122817,69715,62654,1367230
2019,Electrical,894768,315841,144544,80956,34991,1471100
2023,Civil,807193,271881,135710,71644,38146,1324574
2019,Mechanical,661264,320233,130799,65310,76652,1254258
2019,Computer Science,763030,432614,140964,72450,35290,1444348
2021,Civil,719502,315285,133678,66303,54549,1289317
2023,Electrical,830395,309547,140438,97782,44844,1423006
2023,Electrical,732475,443223,141926,74031,58882,1450537
2022,Mechanical,805463,388294,83801,79250,70919,1427727
2019,Mechanical,769708,257933,121048,71853,30028,1250570
2019,Mechanical,872983,333385,120144,67977,48244,1442733
2020,Electrical,835706,470844,90148,92707,37934,1527339
2022,Civil,778901,490839,99861,64465,59845,1493911
2020,Electrical,740302,348706,141717,60225,65340,1356290
2020,Computer Science,651977,459509,102480,90472,78049,1382487
2020,Electrical,825864,388012,98637,66640,70819,1449972
2021,Computer Science,625651,495398,124621,81535,50398,1377603
2021,Civil,697919,334590,140304,89280,60061,1322154
2020,Mechanical,786944,356399,127431,52991,32127,1355892
2022,Mechanical,717776,309145,136172,67801,40083,1270977
2019,Electrical,744811,424682,105437,74144,49091,1398165
2022,Mechanical,730697,307520,88149,57965,39933,1224264
2023,Civil,779428,254544,94671,63730,45877,1238250
2021,Mechanical,601789,471926,103119,79553,64581,1320968
2019,Electrical,836974,304812,126117,58301,42519,1368723
2019,Civil,861413,452682,96279,68936,37816,1517126
2023,Computer Science,768678,432572,148835,92017,38351,1480453
2023,Electrical,644135,420690,84803,64155,45648,1259431
2020,Computer Science,637067,369090,140805,71117,74002,1292081
2021,Civil,879501,349054,98201,98848,57461,1483065
2021,Electrical,770923,406516,108634,52042,71264,1409379
2022,Electrical,807925,467054,94760,68565,74901,1513205
2020,Civil,763944,475151,90826,97602,71359,1498882
2020,Mechanical,669103,437658,125775,87260,74480,1394276
2020,Electrical,686310,405861,86798,86326,69017,1334312
2020,Electrical,637412,382689,146103,92581,45441,1304226
2021,Computer Science,801002,350834,131410,53658,69253,1406157
2021,Mechanical,622228,384405,120888,66319,39177,1233017
2020,Computer Science,720627,290002,129047,69078,64573,1273327
2022,Computer Science,611319,444692,125955,86652,51431,1320049
2019,Mechanical,606475,468760,81982,87548,51924,1296689
2019,Mechanical,828163,470699,113864,69668,64864,1547258
2022,Civil,745800,381583,119265,88720,42493,1377861
2020,Mechanical,841382,362850,126313,90285,35337,1456167
2021,Electrical,891689,380011,124350,72546,46035,1514631
2019,Mechanical,829484,418922,95378,87874,53318,1484976
2023,Civil,792828,371548,149815,87165,72305,1473661
2023,Civil,799847,463244,107924,78898,71190,1521103
2022,Civil,892759,467125,87312,79907,33782,1560885
2020,Mechanical,875890,281786,110353,95411,43798,1407238
2019,Mechanical,753817,455428,96192,79372,49884,1434693
2020,Computer Science,863389,286244,97450,64822,39074,1350979
2019,Computer Science,717408,455786,85432,69776,57349,1385751
2022,Electrical,712143,317261,137225,82406,56907,1305942
2022,Computer Science,889776,268477,145604,60462,51989,1416308
2023,Electrical,875000,427605,90295,86479,69187,1548566
2020,Civil,787965,415541,86774,84354,38624,1413258
2023,Computer Science,832298,258496,92190,92174,37889,1313047
2020,Mechanical,668049,370522,111286,89906,57256,1297019
2023,Computer Science,828953,393342,144014,57662,40455,1464426
2021,Electrical,810503,457080,135256,57404,77200,1537443
2021,Computer Science,770821,270724,138630,96101,41194,1317470
2021,Civil,804829,280416,142771,92605,51622,1372243
2021,Mechanical,802646,285575,131715,59542,56988,1336466
2019,Electrical,658601,462262,87466,65904,37570,1311803
2021,Mechanical,746154,326614,97637,77774,51487,1299666
2022,Mechanical,745720,343566,148745,58556,30617,1327204
2022,Electrical,862508,454180,116317,96123,75452,1604580
2019,Mechanical,765640,398480,129766,62806,71277,1427969
2021,Mechanical,805704,377192,83078,92586,77485,1436045
2021,Computer Science,869580,269359,107299,64864,36285,1347387
2021,Mechanical,624544,389770,83543,80016,63224,1241097
2023,Mechanical,663295,451464,131052,83749,30500,1360060
2020,Mechanical,796787,474135,102064,92996,58994,1524976
2023,Mechanical,669409,420564,94425,86320,66642,1337360
2020,Electrical,849720,455853,131481,67305,53014,1557373
2021,Civil,726839,293634,130530,61938,34973,1247914
2021,Computer Science,879301,367255,105888,66318,34774,1453536
2023,Mechanical,776637,292864,107491,70379,45519,1292890
2023,Mechanical,801068,344482,112352,87820,77117,1422839
2020,Electrical,665888,287355,101676,55406,50580,1160905
2022,Civil,787167,287690,145836,70661,53099,1344453
2020,Mechanical,604507,418886,117463,67858,76390,1285104
2023,Electrical,643988,412717,128990,80816,67484,1333995
2023,Computer Science,747937,465886,143627,62850,72588,1492888
2019,Computer Science,627213,453811,100221,62601,78855,1322701
2023,Mechanical,657450,306630,131313,89866,43302,1228561
2019,Mechanical,662222,429243,109251,76644,33234,1310594
2022,Civil,754468,271658,126586,77428,36494,1266634
2020,Civil,612755,489204,133884,89487,44239,1369569
2020,Mechanical,731937,265797,132620,98624,34498,1263476
2019,Electrical,742245,308799,90040,91362,74198,1306644
2020,Civil,789977,368301,125878,83380,35267,1402803
2023,Mechanical,769169,479414,85969,57286,42546,1434384
2021,Civil,895515,477566,93162,60068,54479,1580790
2019,Mechanical,835132,302236,145435,59805,66437,1409045
2020,Computer Science,735090,256265,85037,53017,39657,1169066
2019,Mechanical,867336,375611,140526,71172,52453,1507098
2019,Computer Science,864159,453206,94693,59926,64729,1536713
2021,Civil,799988,481791,139090,94508,76708,1592085
2023,Mechanical,628343,463750,82451,73486,47259,1295289
2019,Civil,605829,434566,145560,80397,58645,1324997
2020,Computer Science,634381,371754,85962,79511,42093,1213701
2022,Mechanical,812153,433340,96444,93340,38734,1474011
2019,Civil,880407,496524,120443,99005,33516,1629895
2019,Computer Science,834748,408070,96506,60002,45032,1444358
2021,Civil,821970,341426,118384,98586,50883,1431249
2023,Electrical,600148,475486,104248,53201,55594,1288677
2022,Computer Science,888889,442411,126162,83520,70001,1610983
2020,Computer Science,672914,395378,122690,77048,56004,1324034
2022,Computer Science,660653,445078,149625,80130,43170,1378656
2020,Mechanical,823607,499789,148008,90324,68715,1630443
2023,Mechanical,792593,428417,140309,51341,46958,1459618
2020,Mechanical,893219,392957,123237,63981,47842,1521236
2021,Electrical,609795,359681,115732,58696,70163,1214067
2021,Electrical,664555,293826,88104,64525,56075,1167085
2021,Computer Science,835068,305597,114980,76545,56067,1388257
2021,Electrical,703107,388515,119560,78625,33172,1322979
2022,Civil,827650,347375,89554,55565,66195,1386339
2023,Computer Science,767022,497077,125987,64947,70566,1525599
2020,Computer Science,611009,267084,110985,80077,37736,1106891
2020,Civil,778168,339447,128167,90698,78258,1414738
2021,Computer Science,750616,254383,120428,56517,61268,1243212
2021,Electrical,629381,342313,147238,64287,73475,1256694
2019,Mechanical,668122,284361,142723,61829,74511,1231546
2023,Civil,814709,330294,97038,52422,34206,1328669
2022,Electrical,687228,311331,102219,79060,49348,1229186
2020,Civil,680770,345057,84271,96728,66081,1272907
2019,Civil,652726,401601,107397,91633,77823,1331180
2019,Computer Science,788210,439646,109602,55985,71641,1465084
2020,Computer Science,821454,469699,134471,89715,54854,1570193
2022,Electrical,777265,371685,142150,63790,67226,1422116
2019,Civil,845074,486402,124227,97507,48032,1601242
2019,Computer Science,680857,346917,103116,75168,59272,1265330
2023,Computer Science,859405,481988,86674,74019,72118,1574204
2022,Civil,790128,280932,97469,93739,70952,1333220
2019,Electrical,717928,490705,85446,53668,78633,1426380
2022,Electrical,658706,251908,100760,60744,65109,1137227
2020,Civil,655006,486330,81963,78754,64606,1366659
2021,Electrical,687238,494561,107262,69522,35538,1394121
2019,Computer Science,848018,411430,85177,54509,74237,1473371
2023,Civil,794227,280412,91160,52500,39533,1257832
2020,Computer Science,677271,378319,87543,59904,60792,1263829
2022,Mechanical,892321,333710,119278,76921,35477,1457707
2020,Mechanical,643013,462104,109607,66683,39363,1320770
2019,Electrical,682600,252928,97221,62416,42264,1137429
2022,Mechanical,699290,315158,83323,64833,76304,1238908
2021,Computer Science,816110,411704,132105,68290,41819,1470028
2020,Mechanical,731832,282309,146968,85253,42191,1288553
2019,Computer Science,624142,259280,103238,64003,36499,1087162
2023,Electrical,731436,290449,143830,90227,74847,1330789
2022,Electrical,881941,468243,88330,56120,47668,1542302
2020,Computer Science,837403,276957,124153,91253,38762,1368528
2020,Mechanical,632535,417967,88611,64251,61292,1264656
2021,Electrical,616105,320499,93872,72486,49248,1152210
2021,Civil,739011,343057,129455,78334,68813,1358670
2023,Electrical,679472,479223,114930,56172,74944,1404741
2023,Mechanical,773101,360065,142714,72706,41333,1389919
2019,Civil,746935,492930,128716,68472,60652,1497705
2019,Mechanical,678097,402767,146704,71695,71406,1370669
2023,Computer Science,861674,324893,80415,89255,43070,1399307
2023,Civil,741519,444195,89888,92732,55856,1424190
2022,Mechanical,696160,275176,125299,61055,61628,1219318
2021,Civil,646940,399481,138765,82716,67807,1335709
2019,Mechanical,809019,306967,142714,56880,53423,1369003
2021,Civil,685001,250987,95935,78949,78033,1188905
2021,Mechanical,834824,435534,81320,69810,55212,1476700
2023,Computer Science,750714,448573,126032,50528,65741,1441588
2022,Civil,827870,486692,97907,93093,34626,1540188
2020,Civil,826971,346854,118002,68308,79270,1439405
2022,Civil,798715,276015,124838,72844,70767,1343179
2022,Civil,607928,475799,118912,72360,32292,1307291
2021,Computer Science,648002,362350,80552,72405,44859,1208168
2022,Civil,714614,316404,100140,67246,60585,1258989
2019,Electrical,717517,366751,128737,77792,46807,1337604
2021,Computer Science,756089,378807,113367,93322,33819,1375404
2019,Electrical,679064,431353,104061,70704,54087,1339269
2020,Civil,650893,418218,122124,98181,75450,1364866
2021,Mechanical,877311,298231,125638,80589,77553,1459322
2020,Electrical,638598,410104,81982,72436,31280,1234400
2021,Civil,738595,278305,115765,96895,43241,1272801
2023,Electrical,681060,304306,134681,74643,72779,1267469
2022,Civil,875429,469248,143232,68026,44147,1600082
2023,Civil,622694,371139,142349,65693,49816,1251691
2020,Civil,861401,268318,143474,59212,79914,1412319
2022,Mechanical,846848,394318,109513,87964,31629,1470272
2021,Electrical,753463,414916,102592,63850,68267,1403088
2022,Computer Science,866755,413674,103618,89767,38634,1512448
2019,Computer Science,609372,271584,131632,57322,33014,1102924
2022,Computer Science,755384,497399,95409,85911,40773,1474876
2019,Computer Science,745152,265169,89529,96580,47881,1244311
2022,Civil,712945,275968,104154,80387,38280,1211734
2019,Electrical,696213,387457,112882,55678,55555,1307785
2020,Electrical,620874,454830,124917,51382,71421,1323424
2023,Mechanical,804986,372684,95701,71780,49936,1395087
2021,Electrical,611600,365391,148225,77506,57332,1260054
2022,Electrical,848430,275444,132492,92296,74588,1423250
2023,Electrical,755887,484856,82988,81848,57077,1462656
2021,Mechanical,815572,356081,115919,89882,37637,1415091
2021,Computer Science,694348,312497,128426,92202,54955,1282428
2019,Electrical,705736,255362,132167,51705,50880,1195850
2020,Mechanical,886858,349254,89013,55997,76158,1457280
2020,Mechanical,735797,389322,119113,72447,46155,1362834
2023,Civil,751756,318354,83574,90730,33060,1277474
2020,Mechanical,711573,286368,87838,94159,76465,1256403
2022,Computer Science,875236,294109,111368,64535,78081,1423329
2020,Electrical,625457,461661,112228,74480,70278,1344104
2023,Mechanical,662894,438717,129711,81051,32950,1345323
2020,Computer Science,661305,438069,126097,62129,77155,1364755
2022,Mechanical,743684,277426,135773,80785,53802,1291470
2019,Mechanical,833913,367632,108639,79402,36063,1425649
2023,Mechanical,809699,362637,94823,91527,44205,1402891
2019,Mechanical,600559,289023,103510,52704,74690,1120486
2019,Mechanical,637361,372268,118333,77027,56507,1261496
2019,Computer Science,877405,440339,84435,55725,37661,1495565
2021,Electrical,882516,405964,118418,75223,66189,1548310
2021,Electrical,828748,440304,137955,76769,64758,1548534
2019,Electrical,788992,359211,139507,77384,43057,1408151
2023,Electrical,843950,344897,131033,82145,50240,1452265
2022,Computer Science,600037,440297,127219,82892,64250,1314695
2022,Civil,774104,397079,114477,92497,65313,1443470
2020,Civil,697243,329777,122721,80027,66988,1296756
2023,Computer Science,729380,294858,147228,62767,42491,1276724
2021,Computer Science,858430,426145,95523,71481,63410,1514989
2019,Mechanical,634600,470510,112326,87575,43332,1348343
2020,Mechanical,779357,340042,122205,68354,50302,1360260
2022,Mechanical,793080,333098,80125,98777,64354,1369434
2021,Electrical,867311,270239,146735,69146,48793,1402224
2021,Mechanical,857351,444041,96375,71901,36504,1506172
2019,Civil,600432,394137,82711,99966,58425,1235671
2022,Electrical,861550,360951,112437,53101,59811,1447850
2023,Mechanical,669687,291291,108022,78727,79206,1226933
2021,Electrical,844288,288805,89182,84422,77395,1384092
2019,Civil,785221,348831,120950,66515,59746,1381263
2023,Mechanical,818712,399515,92920,74806,47225,1433178
2022,Civil,787840,259290,102144,83162,69696,1302132
2021,Civil,895583,381283,82565,90087,60973,1510491
2023,Civil,764329,333634,133942,53573,67355,1352833
2023,Mechanical,775746,269072,104691,91941,57196,1298646
2023,Computer Science,776443,293290,113799,89874,49290,1322696
2021,Mechanical,829354,335186,146777,75508,72954,1459779
2021,Civil,768369,265115,114510,75985,40124,1264103
2020,Mechanical,634743,255149,108975,93915,67824,1160606
2022,Civil,799824,291992,133242,55060,68750,1348868
2019,Computer Science,679803,267716,126546,99094,32272,1205431
2023,Electrical,801123,347724,103267,95610,36141,1383865
2020,Computer Science,622076,263621,149939,60933,54678,1151247
2019,Computer Science,841424,387892,84897,56632,39161,1410006
2020,Electrical,806384,363065,80163,89523,31071,1370206
2021,Mechanical,850699,423872,132540,93898,47120,1548129
2023,Electrical,734035,436115,110030,72973,55941,1409094
2019,Mechanical,744938,280399,135313,55589,69144,1285383
2019,Mechanical,763377,369374,109870,61612,54133,1358366
2019,Civil,813968,395074,109482,97611,33630,1449765
2019,Civil,894957,293098,111058,68888,30227,1398228
2019,Electrical,866656,295511,137255,69417,78110,1446949
2020,Computer Science,850703,303243,144930,62015,69433,1430324
2023,Electrical,747702,365131,130500,95440,44008,1382781
2021,Mechanical,717907,278750,106379,85744,49954,1238734
2021,Civil,805591,472682,147787,67855,70761,1564676
2021,Electrical,664591,398382,103674,61891,44675,1273213
2021,Electrical,809633,305398,86590,77762,31619,1311002
2020,Civil,833559,463614,111432,56595,42885,1508085
2022,Civil,873495,456279,120426,96172,32204,1578576
2023,Civil,720533,498797,129584,78557,70510,1497981
2019,Mechanical,703627,294345,118015,95593,41694,1253274
2022,Civil,728381,343430,149353,71936,74586,1367686
2021,Computer Science,842264,364921,84600,68281,70342,1430408
2022,Electrical,673309,341729,104690,52192,39373,1211293
2023,Civil,825074,301843,113762,95032,41448,1377159
2019,Civil,872922,391294,117499,83859,79949,1545523
2019,Mechanical,743573,470394,87670,99851,61210,1462698
2023,Mechanical,636382,412581,97341,92861,55410,1294575
2023,Electrical,822426,381458,97015,84946,59028,1444873
2021,Computer Science,623341,314334,145126,99884,32764,1215449
2019,Electrical,745439,317170,135197,96360,73369,1367535
2022,Civil,826280,290878,129849,82309,41467,1370783
2020,Computer Science,731066,450741,95852,91472,38199,1407330
2020,Computer Science,800940,488752,135361,85455,57095,1567603
2023,Computer Science,859252,419421,101258,78672,73179,1531782
2021,Computer Science,685820,481343,142355,53756,62463,1425737
2020,Electrical,659949,403024,121508,88829,69007,1342317
2019,Mechanical,810377,340352,147784,91391,77711,1467615
2023,Mechanical,662543,402601,107410,72918,43617,1289089
2022,Civil,889754,452375,89895,54494,58304,1544822
2023,Mechanical,861878,422593,113924,84047,33329,1515771
2022,Mechanical,804446,268383,92264,56538,61193,1282824
2023,Mechanical,808851,385973,108038,52221,41563,1396646
2023,Mechanical,759011,292889,89136,55164,35584,1231784
2023,Civil,667381,264633,93213,83622,38805,1147654
2022,Electrical,878910,312244,107431,85980,55264,1439829
2022,Computer Science,702416,379177,122290,69152,39089,1312124
2023,Mechanical,612780,400235,147539,64385,43639,1268578
2020,Electrical,648458,440091,122747,73612,54685,1339593
2021,Mechanical,863653,391779,149208,62530,78256,1545426
2021,Mechanical,777946,469184,149015,53340,41110,1490595
2021,Computer Science,631533,333597,94887,73124,63928,1197069
2022,Computer Science,863503,426173,80051,92579,74941,1537247
2022,Computer Science,719119,425778,147695,83043,51128,1426763
2020,Mechanical,821140,458156,149926,62295,70099,1561616
2021,Mechanical,882488,265115,108491,70247,44684,1371025
2021,Mechanical,882745,325379,96080,50714,77566,1432484
2023,Computer Science,845840,483553,114880,88822,54419,1587514
2022,Civil,788057,289979,139965,50809,31527,1300337
2021,Electrical,848182,421713,127361,80144,45220,1522620
2020,Civil,892926,319377,146890,95983,53702,1508878
2020,Mechanical,711095,256416,149290,70362,72873,1260036
2021,Mechanical,739152,391705,96593,91821,57757,1377028
2022,Civil,765029,378785,96167,50036,76664,1366681
2020,Mechanical,826952,484261,113005,82402,43085,1549705
2023,Electrical,721292,381666,145471,74498,45205,1368132
2020,Mechanical,690570,395465,130728,78387,50994,1346144
2019,Electrical,723791,416452,88691,60273,60945,1350152
2019,Civil,638314,426128,89756,75030,50634,1279862
2022,Civil,832061,469351,116308,95267,72966,1585953
2021,Mechanical,805993,380364,144079,61403,60569,1452408
2022,Electrical,746903,347507,145524,65037,60175,1365146
2022,Mechanical,645708,497256,140466,69039,75166,1427635
2022,Computer Science,879826,368243,89327,64017,36626,1438039
2022,Computer Science,766866,385933,108520,67365,65623,1394307
2023,Computer Science,639477,353070,123308,97464,33964,1247283
2023,Computer Science,769809,286126,96533,89215,77377,1319060
2020,Mechanical,733692,330382,124488,62583,77258,1328403
2019,Computer Science,834241,472785,147160,82919,48058,1585163
2022,Electrical,853105,414754,120429,97025,55766,1541079
2020,Civil,766129,268228,131726,94254,76098,1336435
2019,Civil,810462,481371,100653,96275,65160,1553921
2021,Computer Science,653024,274009,136921,59514,46262,1169730
2023,Computer Science,775183,250094,93654,88416,69646,1276993
2019,Computer Science,755146,488060,82108,51511,77672,1454497
2021,Mechanical,617824,330636,149483,68642,64689,1231274
2019,Civil,648926,433293,87899,66615,58965,1295698
2023,Computer Science,767932,348453,93372,81589,40884,1332230
2023,Electrical,875119,398502,117682,74225,34433,1499961
2020,Computer Science,824749,416643,147799,70846,48211,1508248
2022,Civil,845453,304486,116583,79152,40691,1386365
2019,Computer Science,681371,340510,109295,90517,61063,1282756
2019,Civil,757620,477737,146113,50571,63484,1495525
2021,Computer Science,698066,493842,129574,76188,79782,1477452
2023,Electrical,769808,443366,144934,95000,51244,1504352
2019,Computer Science,661562,270860,110066,92530,54660,1189678
2023,Electrical,871978,322812,88945,63217,66536,1413488
2019,Electrical,702192,316087,109418,91999,65475,1285171
2020,Computer Science,600840,494856,129874,56609,60084,1342263
2022,Electrical,810481,389558,97130,97397,78919,1473485
2019,Mechanical,631568,464135,148248,95041,54802,1393794
2023,Computer Science,872990,299607,121394,99322,72267,1465580
2020,Computer Science,736971,390817,129635,55151,79074,1391648
2019,Electrical,686038,356664,97404,56406,50614,1247126
2021,Electrical,797173,459605,93156,97062,35033,1482029
2022,Computer Science,729789,268330,135618,64893,34386,1233016
2019,Mechanical,674723,370803,129999,82956,42150,1300631
2020,Electrical,838755,421150,93785,95841,38157,1487688
2021,Electrical,840822,436404,128359,57145,76881,1539611
2020,Civil,656888,485193,94694,88695,78742,1404212
2020,Mechanical,783206,435604,116114,83367,60408,1478699
2021,Mechanical,868227,471437,149549,63133,37675,1590021
2020,Computer Science,743670,293336,137230,62209,56228,1292673
2021,Mechanical,692416,258070,112799,94292,48251,1205828
2019,Computer Science,864724,251320,91156,97085,53349,1357634
2021,Civil,722834,339043,90304,76965,79178,1308324
2021,Mechanical,712148,288921,120645,59145,45826,1226685
2022,Electrical,788467,256589,118938,97125,75609,1336728
2021,Civil,871530,445481,136982,92585,39124,1585702
2021,Computer Science,750594,342995,82315,84638,36588,1297130
2019,Civil,796604,265589,92420,70645,60943,1286201
2022,Computer Science,633545,286375,98312,68408,78590,1165230
2023,Civil,785151,293085,101395,62521,58034,1300186
2019,Computer Science,888999,310840,120301,71878,52151,1444169
2019,Mechanical,635790,424272,126972,88221,79618,1354873
2023,Electrical,651012,348704,143294,84595,62400,1290005
2021,Computer Science,717827,407804,128225,71086,43536,1368478
2020,Civil,860123,347047,102854,66923,32700,1409647
2022,Computer Science,614260,403498,110929,66225,56074,1250986
2020,Computer Science,796211,280982,137103,57202,38809,1310307
2023,Computer Science,863218,309720,143620,80139,45115,1441812
2019,Civil,740547,397818,124590,81974,75513,1420442
2019,Electrical,809486,278514,90621,76941,49071,1304633
2022,Mechanical,746192,445961,80973,87206,68100,1428432
2019,Electrical,864130,384923,138786,69885,53190,1510914
2019,Computer Science,840201,400868,117097,94907,51440,1504513
2022,Civil,763502,326034,114245,61218,56080,1321079
2022,Electrical,838569,443870,145211,95692,74927,1598269
2023,Computer Science,655479,348388,134841,78750,62947,1280405
2019,Mechanical,864320,444057,105346,81612,37996,1533331
2019,Mechanical,684258,415664,129153,56716,73545,1359336
2023,Mechanical,839423,294845,85972,66088,44862,1331190
2021,Computer Science,684153,397002,128063,81001,68232,1358451
2021,Civil,792990,360853,145488,89586,53104,1442021
2021,Electrical,859642,358417,137055,72584,47305,1475003
2023,Mechanical,833984,363436,144366,54286,65860,1461932
2019,Computer Science,677442,488198,90931,54739,35527,1346837
2023,Computer Science,657124,271159,87702,80158,74559,1170702
2023,Electrical,859488,476144,101540,84857,43727,1565756
2021,Mechanical,678947,339788,137450,55605,59967,1271757
2020,Computer Science,872217,274003,145252,89590,53849,1434911
2019,Electrical,899395,355722,126904,53321,32719,1468061
2021,Civil,696496,285139,132320,94541,78680,1287176
2020,Civil,802509,486444,111000,83984,78235,1562172
2020,Civil,862037,302452,82599,87653,42924,1377665
2022,Mechanical,866626,272205,136165,62170,39215,1376381
2019,Electrical,822036,477131,138855,58933,79303,1576258
2020,Electrical,770646,306955,80018,72692,54588,1284899
2021,Computer Science,869482,491235,80858,81474,55290,1578339
2022,Computer Science,773790,257464,105992,59906,78009,1275161
2019,Computer Science,743572,463718,112580,95004,50009,1464883
2023,Electrical,742617,492924,115800,73814,61912,1487067
2021,Computer Science,661480,453729,138770,85565,31144,1370688
2020,Electrical,736313,259840,134941,50818,67302,1249214
2020,Electrical,820386,483688,117487,58434,44635,1524630
2021,Civil,604695,290768,92943,80571,63488,1132465
2020,Computer Science,808138,390533,141457,90694,31006,1461828
2022,Civil,614318,270927,98836,78890,41490,1104461
2019,Mechanical,783744,471006,91394,95485,57044,1498673
2022,Mechanical,691891,348622,105280,62069,37099,1244961
2020,Mechanical,824757,265329,81159,82780,53500,1307525
2023,Electrical,668754,265791,103440,88662,75079,1201726
2019,Electrical,640077,302627,132712,73434,30537,1179387
2019,Electrical,735311,378885,127656,57392,78697,1377941
2021,Computer Science,841504,395444,86589,66102,41016,1430655
2021,Civil,891813,495311,128241,83457,65453,1664275
2023,Electrical,735222,473962,103233,72262,31980,1416659
2019,Civil,742181,429541,115011,61932,35906,1384571
2023,Civil,830822,359554,88177,61766,63307,1403626
2021,Civil,757088,380436,114528,72711,53430,1378193
2021,Computer Science,743008,337073,141351,63292,74844,1359568
2019,Computer Science,742108,499894,136831,70687,58629,1508149
2022,Mechanical,745093,284370,131827,97631,57775,1316696
2020,Mechanical,899087,301408,103508,75899,70029,1449931
2021,Civil,713694,340941,134933,57408,60398,1307374
2021,Mechanical,834456,488423,148772,60694,71988,1604333
2022,Civil,812079,404775,95611,90910,30051,1433426
2022,Computer Science,844269,396306,102282,84533,54818,1482208
2023,Computer Science,845385,388604,121003,65237,31686,1451915
2023,Computer Science,723351,486742,91340,55778,49205,1406416
2020,Electrical,603770,285416,98165,85059,52947,1125357
2020,Civil,653811,322439,98260,76561,38096,1189167
2019,Computer Science,866145,268242,134515,54866,72800,1396568
2023,Civil,660848,431326,110480,58429,38616,1299699
2021,Mechanical,652635,329324,132527,93352,73087,1280925
2023,Mechanical,620946,285249,139789,94515,38545,1179044
2021,Computer Science,695852,350124,131902,72837,66458,1317173
2022,Civil,717729,345049,112191,84075,38484,1297528
2023,Computer Science,770231,489647,139488,84853,30716,1514935
2022,Mechanical,885815,335078,116044,76395,53667,1466999
2020,Computer Science,747522,282294,129600,66415,59200,1285031
2020,Civil,696748,440856,128776,81986,34575,1382941
2019,Mechanical,839292,384756,92836,74104,50956,1441944
2023,Electrical,704733,404867,132648,50291,40670,1333209
2022,Mechanical,726865,441373,93740,53686,45637,1361301
2021,Electrical,879302,450259,93102,95347,46346,1564356
2020,Computer Science,662576,391503,131334,51642,56940,1293995
2020,Computer Science,755260,456739,110255,81477,63405,1467136
2021,Civil,823687,339627,105221,74150,70747,1413432
2022,Electrical,735091,340381,143265,58769,39491,1316997
2022,Computer Science,612419,340027,80719,79833,42631,1155629
2023,Electrical,633697,436444,103140,53909,51934,1279124
2023,Computer Science,695428,320366,135779,82078,57182,1290833
2019,Mechanical,739045,344176,81069,62268,38903,1265461
2020,Computer Science,839073,369667,134714,60844,57186,1461484
2023,Civil,686649,322870,92935,58638,41725,1202817
2022,Mechanical,873280,297387,124035,87141,42070,1423913
2021,Civil,762357,433999,107937,61233,66109,1431635
2022,Mechanical,885183,259304,98540,80496,46068,1369591
2020,Electrical,723168,494255,128702,67806,35550,1449481
2022,Civil,688263,267032,116907,90326,48167,1210695
2019,Computer Science,659155,341291,95221,63271,55443,1214381
2020,Electrical,616911,362889,134781,89513,44688,1248782
2021,Computer Science,600916,309486,87087,69465,79619,1146573
2019,Mechanical,832695,315552,102789,89502,68351,1408889
2020,Mechanical,879934,454916,136023,63860,59548,1594281
2021,Computer Science,721937,410726,113400,58250,42113,1346426
2019,Computer Science,685053,289244,82199,91418,52289,1200203
2019,Electrical,899840,387014,127316,99255,48160,1561585
2020,Computer Science,702395,300697,132062,71310,63849,1270313
2023,Civil,797298,376031,96744,99893,76205,1446171
2019,Civil,625103,252693,135517,77982,49309,1140604
2019,Computer Science,857777,437823,128865,82206,66852,1573523
2021,Civil,657730,331098,93894,59764,75021,1217507
2022,Computer Science,625825,499849,109160,93661,70396,1398891
2020,Electrical,807328,256259,133095,62842,36195,1295719
2020,Civil,637271,369746,109272,87491,31011,1234791
2023,Civil,677256,494955,134021,94372,54286,1454890
2023,Computer Science,666433,357772,113645,74043,63581,1275474
2020,Civil,813702,367928,101179,87971,42138,1412918
2023,Mechanical,701999,386014,90691,52976,56719,1288399
2021,Electrical,832062,297419,125311,57426,63040,1375258
2020,Electrical,623572,352092,119038,72887,78450,1246039
2023,Civil,638546,306105,104967,76710,50028,1176356
2020,Civil,806271,446979,108478,91387,46192,1499307
2022,Mechanical,636948,408455,135775,97470,48100,1326748
2019,Mechanical,889151,273404,120332,56486,36276,1375649
2020,Civil,700819,322656,87066,89258,57551,1257350
2019,Civil,622024,386774,119313,96882,36828,1261821
2023,Mechanical,843480,454955,147857,72623,63124,1582039
2019,Computer Science,682912,350965,125900,73806,43654,1277237
2020,Mechanical,855233,306332,121098,55973,30203,1368839
2022,Computer Science,833746,420491,88294,96215,50129,1488875
2023,Electrical,861139,471648,142580,98626,36614,1610607
2020,Electrical,732828,353182,118101,95939,77567,1377617
2023,Mechanical,831749,361395,105059,99085,63264,1460552
2021,Computer Science,702488,352619,120626,79157,42989,1297879
2019,Mechanical,696741,469150,100703,55521,79214,1401329
2021,Mechanical,789123,358269,141417,62891,31579,1383279
2020,Computer Science,831773,323844,139228,66795,34876,1396516
2022,Mechanical,774166,420314,83205,72474,70618,1420777
2023,Electrical,818961,374983,114929,76507,34125,1419505
2019,Civil,647367,284142,113411,60687,35328,1140935
2023,Civil,838544,359699,91628,83014,78968,1451853
2020,Mechanical,659884,346226,86518,61009,72040,1225677
2023,Computer Science,744352,257393,118491,73226,41696,1235158
2019,Computer Science,653251,451011,87946,72948,66147,1331303
2020,Electrical,684821,450154,80610,84939,46119,1346643
2023,Computer Science,683583,352281,149838,94291,54017,1334010
2022,Computer Science,844697,409965,114311,98296,78780,1546049
2020,Electrical,610207,259388,121876,98044,56204,1145719
2020,Mechanical,802199,499171,130333,90225,49562,1571490
2022,Civil,627757,488364,131298,72102,54428,1373949
2021,Electrical,751328,312969,121811,84828,51497,1322433
2019,Mechanical,895966,286660,122974,86102,33372,1425074
2021,Electrical,862070,339244,99856,95855,53147,1450172
2023,Mechanical,641340,405798,124830,83712,47453,1303133
2022,Electrical,842955,329544,125823,76823,77180,1452325
2021,Mechanical,675320,482625,147078,55361,63960,1424344
2020,Electrical,882081,444068,147951,75838,47197,1597135
2023,Mechanical,873363,381183,92905,64638,63920,1476009
2023,Electrical,609399,365370,101601,88052,31883,1196305
2021,Civil,726733,267545,120955,73265,46651,1235149
2021,Civil,829920,421240,128435,74751,50055,1504401
2022,Computer Science,882191,383451,104044,92012,32812,1494510
2019,Mechanical,831615,476845,91246,60916,60445,1521067
2021,Electrical,685693,492556,82458,59509,75640,1395856
2021,Mechanical,700931,337346,138507,95532,36562,1308878
2020,Civil,775963,422192,86028,81102,37013,1402298
2023,Mechanical,737852,267809,131901,97659,35177,1270398
2019,Electrical,889194,433885,86306,74324,50469,1534178
2020,Mechanical,673551,455077,107678,64003,79535,1379844
2022,Electrical,824691,277967,92363,77943,61229,1334193
2022,Civil,682016,390820,94066,92634,59101,1318637
2021,Civil,713135,273424,143804,83101,57987,1271451
2021,Civil,653010,467584,128544,79943,53105,1382186
2022,Computer Science,832084,404986,80189,59456,53467,1430182
2021,Civil,638165,476675,91752,61369,47433,1315394
2019,Mechanical,873672,358411,87482,69329,48217,1437111
2021,Computer Science,780680,459550,96679,63218,61308,1461435
2023,Civil,637136,400563,80799,71164,38989,1228651
2021,Mechanical,612076,430526,89934,87424,67235,1287195
2020,Mechanical,755855,320069,137558,62410,49359,1325251
2019,Mechanical,777788,432997,139223,79730,35155,1464893
2020,Electrical,650298,339119,121556,52665,76904,1240542
2020,Computer Science,669835,287049,89909,89899,37961,1174653
2023,Mechanical,712424,277821,123558,87703,53983,1255489
2019,Electrical,739190,345797,108013,50415,37186,1280601
2019,Civil,854394,484144,102875,83475,37506,1562394
2019,Mechanical,703088,411017,91408,74172,71026,1350711
2019,Electrical,615185,398456,115607,52684,76070,1258002
2019,Mechanical,650613,409482,141684,57494,78951,1338224
2023,Computer Science,841084,327734,116281,69750,60225,1415074
2021,Computer Science,764999,444838,107326,69887,37791,1424841
2020,Civil,862530,475962,93601,70826,57597,1560516
2019,Mechanical,892164,497478,81135,56180,36770,1563727
2021,Electrical,642678,388241,102741,96779,39893,1270332
2021,Civil,817767,421201,91913,52559,55154,1438594
2020,Mechanical,661394,347445,90101,90905,54318,1244163
2023,Civil,800017,253830,98631,53971,70755,1277204
2022,Electrical,715377,437378,116870,85725,69933,1425283
2022,Civil,721716,336940,128985,68113,43514,1299268
2021,Civil,787486,446339,107215,92861,61358,1495259
2020,Civil,655918,408829,142110,62951,52438,1322246
2022,Mechanical,842556,313867,99215,75617,67273,1398528
2021,Electrical,760527,416722,94024,82794,57456,1411523
2023,Computer Science,769807,414838,125483,52583,53631,1416342
2022,Mechanical,694702,462550,90511,75628,35807,1359198
2021,Computer Science,705509,282419,99923,76250,36256,1200357
2021,Computer Science,714310,266668,90558,53055,45156,1169747
2019,Mechanical,799092,397318,80526,56801,41908,1375645
2023,Mechanical,634622,274996,81753,84426,54435,1130232
2019,Electrical,709935,301312,106248,86719,34284,1238498
2020,Electrical,860440,384137,94656,90067,60432,1489732
2019,Civil,717919,260467,103266,73840,44438,1199930
2019,Computer Science,772026,431718,144555,59933,64922,1473154
2022,Electrical,669519,491452,142995,81979,70510,1456455
2021,Civil,787187,402079,145402,95047,44227,1473942
2023,Electrical,856587,449151,134176,54137,44265,1538316
2019,Mechanical,748112,278702,121733,61423,49188,1259158
2023,Electrical,644772,344369,94418,74315,48604,1206478
2019,Computer Science,722431,325569,117185,84482,58565,1308232
2020,Electrical,794904,303952,121745,94156,62588,1377345
2019,Computer Science,758988,439137,133787,86115,71958,1489985
2022,Mechanical,888516,284169,132035,84754,62074,1451548
2021,Computer Science,639080,266829,145984,86312,47105,1185310
2020,Electrical,706242,441207,132462,73363,55790,1409064
2019,Civil,629048,254522,117353,67085,53358,1121366
2023,Mechanical,685205,335687,128302,92414,60944,1302552
2020,Electrical,767403,416391,102435,86554,52187,1424970
2020,Mechanical,856392,370334,137728,64415,34025,1462894
2019,Mechanical,620968,407615,81238,97052,58155,1265028
2020,Electrical,834417,368576,93049,71398,54512,1421952
2023,Electrical,611292,484192,137193,82691,45907,1361275
2020,Civil,851942,367419,115584,56659,44469,1436073
2023,Mechanical,849004,411545,146634,70644,67924,1545751
2019,Mechanical,684193,257699,94679,53044,77196,1166811
2021,Electrical,669165,318165,114505,53883,44410,1200128
2020,Computer Science,701398,421527,131341,81712,73763,1409741
2021,Electrical,822182,325692,130374,69324,67580,1415152
2023,Mechanical,753329,267441,126998,98119,38650,1284537
2020,Electrical,700588,280716,135701,71545,78826,1267376
2022,Civil,852822,312175,124859,68204,56277,1414337
2021,Computer Science,822345,256834,113178,73268,32456,1298081
2020,Electrical,808655,268179,107575,65762,46590,1296761
2021,Civil,884257,276219,99329,78371,57892,1396068
2020,Mechanical,862838,353153,137254,68847,47740,1469832
2019,Electrical,615588,396854,120068,86139,75728,1294377
2021,Mechanical,792828,462435,138951,91295,41788,1527297
2022,Civil,842431,324967,115171,60116,53845,1396530
2022,Mechanical,845456,352454,88262,80125,37156,1403453
2023,Civil,792214,490665,123270,81404,77033,1564586
2020,Civil,664373,259496,100785,78436,38151,1141241
2021,Civil,606704,469939,119469,52788,56515,1305415
2023,Electrical,640136,420310,148831,82149,40987,1332413
2021,Mechanical,667507,296025,125643,54125,42560,1185860
2020,Mechanical,647361,309886,147657,53606,32673,1191183
2022,Computer Science,742513,404635,83582,91534,77767,1400031
2019,Computer Science,614677,253712,110280,82988,36823,1098480
2022,Computer Science,889962,344067,122589,71306,69644,1497568
2023,Computer Science,864012,295489,120000,92973,58365,1430839
2019,Mechanical,683591,282664,81085,60833,68741,1176914
2023,Civil,673168,491871,95600,71997,38282,1370918
2020,Civil,743115,393492,139801,83521,71435,1431364
2019,Electrical,671939,435682,141739,79948,38056,1367364
2023,Civil,877876,255315,121596,96643,64814,1416244
2020,Mechanical,871484,451989,132188,57488,51691,1564840
2022,Mechanical,835560,325033,106825,89974,70504,1427896
2020,Mechanical,884538,475648,90913,92448,66458,1610005
2021,Electrical,735174,367862,94332,57938,58601,1313907
2020,Computer Science,619159,478983,134895,88726,51013,1372776
2020,Civil,722366,329030,84432,65770,65513,1267111
2021,Mechanical,796164,313910,106570,56635,53407,1326686
2023,Mechanical,868356,478360,86103,58629,54660,1546108
2023,Computer Science,899549,442044,95900,99934,32639,1570066
2020,Mechanical,841876,371075,138415,81668,51320,1484354
2021,Civil,824065,471965,147567,71487,30076,1545160
2021,Electrical,610532,305919,142713,62869,36473,1158506
2022,Mechanical,810126,463558,138639,99371,40622,1552316
2023,Civil,816351,462360,88988,59219,48808,1475726
2019,Mechanical,703021,483998,82977,90797,35296,1396089
2023,Computer Science,865415,385204,134641,99040,52951,1537251
2023,Mechanical,600209,377153,81268,66673,52470,1177773
2022,Mechanical,822071,291598,134431,66763,30405,1345268
2019,Electrical,736611,474884,96756,94933,75076,1478260
2022,Computer Science,882121,486371,100764,61043,45345,1575644
2019,Computer Science,805214,401623,139912,59570,30397,1436716
2020,Electrical,709920,473583,120385,56886,44665,1405439
2019,Mechanical,830144,318206,95032,51958,44560,1339900
2022,Civil,867751,324900,125702,93087,56376,1467816
2023,Computer Science,816194,276296,91885,74641,49857,1308873
2019,Computer Science,783011,471288,89796,52183,62506,1458784
2019,Mechanical,749666,399138,112863,79070,72768,1413505
2021,Mechanical,607399,409964,112117,53774,67757,1251011
2023,Computer Science,726812,325577,100753,79018,50310,1282470
2020,Mechanical,698662,455662,100325,70303,48328,1373280
2022,Civil,895761,327173,87021,64272,71397,1445624
2020,Computer Science,738570,457365,133096,72586,68159,1469776
2023,Civil,848304,314771,93071,83545,62990,1402681
2019,Civil,871772,487866,144649,52566,37830,1594683
2019,Mechanical,607032,408556,88041,92863,78998,1275490
2023,Civil,779166,327865,120058,60953,66768,1354810
2019,Mechanical,702658,349074,128263,81696,49048,1310739
2019,Electrical,655264,408187,124470,57404,76255,1321580
2019,Mechanical,694120,407110,108223,82846,51748,1344047
2022,Civil,647850,286622,113575,51581,35393,1135021
2022,Electrical,604722,285886,125799,64066,53885,1134358
2021,Mechanical,879916,432356,101661,90735,30603,1535271
2020,Civil,604576,390973,116432,57839,36295,1206115
2023,Computer Science,757779,306377,111147,84930,71148,1331381
2023,Computer Science,641476,332910,109114,72129,37103,1192732
2023,Mechanical,848292,430934,86030,80845,55251,1501352
2021,Mechanical,886298,368992,127429,63913,79789,1526421
2022,Computer Science,879309,492898,127743,50964,44546,1595460
2021,Civil,614439,413878,145615,60739,45456,1280127
2023,Civil,644518,398731,127577,52673,48228,1271727
2020,Civil,819123,495378,82966,88061,44674,1530202
2019,Mechanical,626962,404525,83728,81171,30046,1226432
2022,Electrical,839157,411570,117304,73643,30819,1472493
2022,Electrical,899907,451465,129277,84486,66575,1631710
2021,Electrical,716189,266312,80947,60624,49406,1173478
2022,Electrical,710290,251436,146130,51228,31080,1190164
2023,Electrical,881608,277569,101414,93370,33146,1387107
2023,Mechanical,723980,439885,99439,84608,41926,1389838
2021,Mechanical,827021,366787,138220,99649,45930,1477607
2023,Electrical,764342,340485,126785,66920,77940,1376472
2020,Mechanical,642299,454301,116973,69689,45287,1328549
2021,Mechanical,816877,427058,148196,57124,69509,1518764
2020,Electrical,631541,352555,86089,92124,64985,1227294
2019,Civil,823070,434249,142235,81339,32886,1513779
2020,Mechanical,729188,390377,109400,57587,43344,1329896
2019,Civil,808150,282646,95405,53527,52018,1291746
2019,Mechanical,891909,473910,132763,83067,71755,1653404
2020,Mechanical,885913,326126,110209,95358,37293,1454899
2021,Electrical,819073,367922,97424,53963,33006,1371388
2023,Mechanical,620156,290430,100556,87455,69726,1168323
2023,Computer Science,816908,372238,99330,86939,54356,1429771
2019,Computer Science,744507,318659,83236,70243,73349,1289994
2019,Electrical,800722,365341,149216,82693,66911,1464883
2021,Civil,777408,254158,110312,95835,44699,1282412
2022,Civil,673631,324236,101191,53695,58434,1211187
2020,Civil,669487,326067,116640,59112,47602,1218908
2019,Computer Science,842735,408810,142293,82059,70786,1546683
2023,Civil,795254,259879,116688,57242,39952,1269015
2021,Civil,651786,386615,104122,59941,71684,1274148
2020,Electrical,668304,362284,121224,70001,60489,1282302
2021,Civil,777586,428996,86331,52700,62905,1408518
2020,Computer Science,720938,423420,122262,68085,76924,1411629
2020,Computer Science,655107,334117,139592,63339,43381,1235536
2019,Computer Science,845191,417751,113926,65834,43893,1486595
2021,Electrical,732232,460190,97528,61084,58130,1409164
2021,Electrical,672577,293888,80068,79543,60415,1186491
2023,Mechanical,815375,280276,149253,85930,79128,1409962
2023,Civil,860933,484611,123968,91074,49143,1609729
2019,Electrical,704180,254799,128623,81902,62826,1232330
2019,Computer Science,882068,471699,122129,79044,79922,1634862
2022,Computer Science,744954,474842,141321,63137,30388,1454642
2023,Electrical,811346,362529,91526,84905,42116,1392422
2020,Electrical,601095,374713,106709,99182,49806,1231505
2021,Electrical,772055,340141,95063,55948,69780,1332987
2019,Mechanical,614123,441630,84723,97461,75394,1313331
2021,Computer Science,797687,365013,84213,82567,34852,1364332
2021,Mechanical,651999,417606,102797,81189,79747,1333338
2022,Mechanical,893297,281668,125217,98867,38627,1437676
2023,Civil,880488,385183,148283,98978,59048,1571980
2019,Computer Science,830849,405758,103655,81871,64750,1486883
2021,Computer Science,637656,453623,92587,68189,57014,1309069
2019,Electrical,801587,322392,102555,72797,77584,1376915
2020,Electrical,860587,266490,108071,53569,41060,1329777
2022,Civil,863356,416266,100239,76012,75169,1531042
2020,Mechanical,720385,395569,129151,62977,73179,1381261
2019,Electrical,740073,434588,82203,82049,38209,1377122
2019,Electrical,678784,367219,93635,71694,68197,1279529
2023,Computer Science,631368,469802,132571,94388,42158,1370287
2021,Computer Science,801891,294104,81144,83224,48076,1308439
2021,Electrical,661160,255316,112699,66832,34376,1130383
2020,Computer Science,756926,288130,92213,82835,49651,1269755
2022,Civil,872859,451301,96944,51862,53948,1526914
2021,Electrical,658784,357294,146723,68186,48079,1279066
2023,Computer Science,626797,279954,148669,79545,43978,1178943
2020,Civil,614780,363437,148947,95522,42705,1265391
2020,Computer Science,637905,402724,114457,94391,56907,1306384
2023,Computer Science,716049,395250,115191,90322,51831,1368643
2022,Computer Science,729651,490005,137924,58319,73629,1489528
2023,Electrical,633359,432235,113744,88663,37965,1305966
2022,Mechanical,673391,395823,133424,95788,40248,1338674
2023,Computer Science,699596,447033,112886,78401,76988,1414904
2023,Civil,847414,384116,80972,82228,53633,1448363
2019,Electrical,878715,313165,86621,62202,59503,1400206
2020,Electrical,750214,392552,129738,88283,37461,1398248
2023,Civil,887248,446511,137694,70122,56998,1598573
2023,Computer Science,608625,424946,134777,83135,42821,1294304
2021,Mechanical,893362,485605,94530,72585,49870,1595952
2020,Computer Science,775544,316775,87354,98408,43410,1321491
2021,Civil,723182,387638,126529,98229,52185,1387763
2020,Electrical,620566,335311,131714,64897,49133,1201621
2021,Mechanical,633205,483589,121232,71291,54169,1363486
2023,Electrical,709084,303149,132079,82826,53359,1280497
2023,Civil,629717,384078,92550,58294,57400,1222039
2019,Computer Science,781056,322561,140385,54507,64173,1362682
2021,Mechanical,759236,400495,144736,99937,41179,1445583
2022,Electrical,620169,485934,110268,78854,66343,1361568
2019,Electrical,883748,340710,84290,97520,65495,1471763
2021,Electrical,728140,342199,135034,65475,36487,1307335
2021,Computer Science,702537,415024,110138,94905,44760,1367364
2019,Mechanical,846337,277326,93432,64334,56439,1337868
2023,Computer Science,711301,367272,147058,68830,56929,1351390
2021,Computer Science,870151,281139,138175,97882,36291,1423638
2023,Computer Science,831704,443175,113329,98803,57472,1544483
2019,Civil,717419,493806,149076,77278,59403,1496982
2023,Civil,805863,441929,92328,68749,32501,1441370
2020,Civil,828870,323638,114247,80511,73040,1420306
2022,Mechanical,867926,493245,86677,87469,31755,1567072
2021,Computer Science,666770,322652,141810,90185,66158,1287575
2022,Computer Science,657645,262937,130357,75072,35816,1161827
2023,Civil,703509,280161,135812,92326,47600,1259408
2021,Computer Science,830796,385455,121616,81146,62616,1481629
2023,Computer Science,891348,335856,141284,61057,31890,1461435
2020,Electrical,617152,497459,129741,76427,41223,1362002
2019,Computer Science,838972,320043,133478,91982,76597,1461072
2021,Electrical,816096,395807,134056,94090,54966,1495015
2020,Computer Science,833731,309919,125534,98654,37688,1405526
2020,Mechanical,881833,476321,144162,61036,69268,1632620
2021,Civil,781762,332055,124711,64060,69484,1372072
2023,Electrical,788392,448633,102805,63607,57553,1460990
2020,Civil,787163,335455,100143,85102,33746,1341609
2022,Electrical,638712,418694,142473,74074,48579,1322532
2020,Electrical,857387,288135,96017,98864,43014,1383417
2023,Electrical,836502,416730,143202,69773,78443,1544650
2023,Mechanical,796349,334677,121423,82970,71961,1407380
2022,Computer Science,620478,279696,121713,82998,66397,1171282
2020,Electrical,622551,384845,82205,78210,37766,1205577
2023,Mechanical,648068,274956,133266,94088,36147,1186525
2021,Electrical,693608,265819,92342,61683,77881,1191333
2019,Computer Science,635561,251528,149563,52962,77210,1166824
2019,Electrical,733964,377781,143190,85095,77178,1417208
2019,Mechanical,886539,336491,101200,80000,31063,1435293
2020,Computer Science,618756,294588,87188,79137,38830,1118499
2022,Mechanical,847652,451657,82808,85552,73702,1541371
2023,Computer Science,851227,349152,93851,96253,39334,1429817
2021,Computer Science,780378,377872,144928,83571,40312,1427061
2021,Civil,752418,401583,95058,95321,55127,1399507
2020,Civil,890168,260119,94620,97350,66043,1408300
2019,Civil,826022,325893,132755,93861,30976,1409507
2020,Computer Science,605947,266167,142995,89164,75151,1179424
2022,Electrical,727192,437575,116681,97578,74174,1453200
2022,Mechanical,857591,360782,144509,66559,41739,1471180
2023,Mechanical,858492,468861,147703,92404,34069,1601529
2023,Mechanical,838826,380775,147680,98074,45604,1510959
2022,Civil,744490,284889,147703,94963,44612,1316657
2022,Computer Science,826494,295678,122136,55691,79102,1379101
2022,Civil,831391,476406,116343,53532,69170,1546842
2020,Electrical,786256,310262,98254,98991,75101,1368864
2022,Computer Science,845318,385753,141273,70733,30345,1473422
2021,Mechanical,772905,330291,139611,67927,67710,1378444
2019,Civil,618402,316008,140002,93114,49326,1216852
2022,Civil,773917,497547,92926,63482,39363,1467235
2019,Electrical,675851,479489,144264,76681,33770,1410055
2020,Electrical,612834,394762,107563,55456,74121,1244736
2019,Civil,667850,275912,110688,53413,38424,1146287
2020,Electrical,637180,256473,114130,57085,41990,1106858
2021,Mechanical,709688,422370,80925,77937,38048,1328968
2020,Electrical,806659,399741,131595,70563,58722,1467280
2020,Electrical,873839,349500,96321,59332,74867,1453859
2023,Civil,727135,463070,90769,87575,74659,1443208
2022,Civil,754195,402015,116748,57386,62137,1392481
2022,Computer Science,658481,288785,120028,76337,45573,1189204
2021,Computer Science,673438,350956,96151,84708,46834,1252087
2021,Civil,711491,444499,114187,79572,39554,1389303
2022,Electrical,721844,443073,123835,83424,63118,1435294
2023,Electrical,656494,442796,80059,85271,57272,1321892
2022,Computer Science,807167,369006,107235,99810,72268,1455486
2023,Computer Science,654672,260832,147114,61030,66772,1190420
2021,Computer Science,661821,386457,125366,63138,41117,1277899
2019,Mechanical,669224,476970,112160,97369,51062,1406785
2021,Mechanical,834745,395780,85277,65646,46628,1428076
2021,Computer Science,654796,439672,81780,78812,43015,1298075
2020,Electrical,728554,404510,126579,73422,34734,1367799
2020,Computer Science,866167,332747,140750,60645,75639,1475948
2020,Mechanical,845358,330107,136902,64628,45162,1422157
2020,Electrical,813708,441134,112161,74486,79592,1521081
2023,Mechanical,767807,315428,124499,72409,74505,1354648
2022,Electrical,639218,336843,111886,89266,39659,1216872
2019,Mechanical,829766,261002,88800,72732,46795,1299095
2021,Electrical,890604,417225,129460,96557,63581,1597427
2023,Electrical,631017,403512,149843,69425,58917,1312714
2019,Electrical,619515,317501,82364,62195,48114,1129689
2023,Electrical,808106,282556,96568,68722,36643,1292595
2023,Civil,895145,317963,118092,66494,43269,1440963
2021,Mechanical,601391,482217,142679,71571,48358,1346216
2022,Mechanical,796278,471797,145781,84486,63317,1561659
2020,Civil,709388,471746,88430,72900,77220,1419684
2022,Electrical,679720,256563,118692,50125,62493,1167593
2021,Electrical,889258,460995,110086,98814,48321,1607474
2021,Mechanical,742954,255840,129671,69318,30203,1227986
2021,Civil,748345,265154,93901,88685,45718,1241803
2019,Electrical,645647,274194,83907,93162,66356,1163266
2022,Electrical,795964,446092,108604,57590,65304,1473554
2022,Electrical,642679,427933,117869,84850,52172,1325503
2023,Computer Science,862571,403520,94537,62134,38298,1461060
2023,Civil,828024,477532,92501,75230,50195,1523482
2023,Electrical,666267,273528,117371,65058,65469,1187693
2021,Computer Science,600799,410474,116821,64301,74857,1267252
2022,Civil,607025,254352,86073,87861,40411,1075722
2021,Electrical,614481,250184,141005,77039,37825,1120534
2019,Mechanical,887555,391456,98101,50284,61238,1488634
2023,Computer Science,827966,264319,111426,88334,68742,1360787
2021,Computer Science,705928,370497,87313,93525,34090,1291353
2021,Electrical,723014,401521,110773,90986,53340,1379634
2019,Electrical,651690,306333,108003,68658,57151,1191835
2020,Computer Science,652870,291205,139668,78443,73327,1235513
2022,Mechanical,767207,260426,122294,53972,39252,1243151
2020,Mechanical,686928,257504,93582,76167,65314,1179495
2023,Civil,809870,437650,93760,63679,33736,1438695
2021,Electrical,670765,439281,115983,94341,77368,1397738
2019,Mechanical,885916,366775,120309,79519,31672,1484191
2019,Civil,880943,283368,109715,75704,30401,1380131
2022,Mechanical,729941,487180,116415,86881,45322,1465739
2020,Electrical,623555,492625,131581,81948,55177,1384886
2022,Civil,865232,353841,83652,64378,41191,1408294
2021,Civil,645783,433257,106297,60328,67081,1312746
2022,Civil,601115,478702,94028,74732,44665,1293242
2019,Mechanical,799198,366744,93803,67673,74412,1401830
2019,Electrical,672908,461293,86307,60373,74594,1355475
2023,Civil,669109,258724,111325,55720,79239,1174117
2023,Computer Science,865122,386156,138616,55153,79071,1524118
2021,Electrical,609422,415882,140483,56226,69047,1291060
2020,Computer Science,774698,463349,111574,52976,61513,1464110
2022,Computer Science,689233,332297,147071,88019,32967,1289587
2021,Civil,637743,375099,94932,86267,67018,1261059
2023,Civil,801533,328872,95749,69297,54795,1350246
2022,Mechanical,729000,401944,88727,66587,33238,1319496
2023,Mechanical,629430,460022,135406,68206,38513,1331577
2022,Mechanical,628834,320333,97332,75935,32738,1155172
2020,Electrical,624435,449915,90834,79633,34936,1279753
2021,Mechanical,687212,493097,100325,60736,64604,1405974
2022,Computer Science,655797,479176,89213,91401,60806,1376393
2019,Mechanical,654555,252596,81403,56971,31568,1077093
2019,Civil,685350,267167,136971,59507,73282,1222277
2022,Mechanical,614716,337844,134030,75724,60860,1223174
2022,Electrical,660261,498139,87591,72166,76815,1394972
2022,Electrical,864139,339751,92996,63158,34720,1394764
2019,Computer Science,622414,379817,132485,75774,70725,1281215
2019,Electrical,744916,458403,127830,61108,73923,1466180
2022,Mechanical,767731,330520,114370,62077,38544,1313242
2023,Civil,615522,308326,137572,54175,55604,1171199
2023,Electrical,739596,327670,109098,85627,69293,1331284
2020,Computer Science,630846,391854,141561,52962,46083,1263306
2021,Mechanical,714930,423074,82196,63616,37935,1321751
2023,Computer Science,886543,468259,91091,82253,60029,1588175
2019,Electrical,806232,274022,145254,67751,56585,1349844
2023,Electrical,823734,334458,129262,95625,53898,1436977
2020,Computer Science,819739,395690,86023,55210,53449,1410111
2020,Mechanical,723182,398317,100543,82390,36737,1341169
2021,Electrical,648591,333796,140029,85677,65308,1273401
2023,Civil,751786,391099,122337,93176,50203,1408601
2019,Electrical,898021,395058,120409,86173,59059,1558720
2019,Mechanical,684106,360704,89963,65993,55448,1256214
2022,Electrical,678018,384598,93796,76859,47218,1280489
2019,Computer Science,764486,472869,120972,70878,49708,1478913
2021,Electrical,720832,294361,83261,64923,47013,1210390
2021,Electrical,686576,448230,97046,83588,32986,1348426
2019,Mechanical,810015,288286,93397,77100,77726,1346524
2019,Computer Science,854664,279533,140436,74086,54317,1403036
2022,Mechanical,776540,482033,105757,90023,55382,1509735
2019,Electrical,810774,399388,95299,97709,36485,1439655
2022,Civil,803180,389771,81902,82571,60504,1417928
2022,Electrical,692508,460563,122399,61017,53528,1390015
2019,Mechanical,794405,377441,128330,87221,41772,1429169
2020,Civil,642464,347079,126308,69513,40152,1225516
2020,Mechanical,753995,499238,83846,94974,42531,1474584
2022,Mechanical,716062,350960,92359,96478,60078,1315937
2019,Computer Science,698384,308465,129376,64860,68635,1269720
2020,Civil,798691,397745,148056,58086,55919,1458497
2019,Electrical,777218,273395,120832,98544,52900,1322889
2019,Mechanical,617140,354162,100098,68050,67394,1206844
2019,Electrical,864814,380704,129962,90157,65030,1530667
2023,Computer Science,898663,404779,115885,69784,32414,1521525
2019,Computer Science,644512,465821,101157,61774,40353,1313617
2023,Civil,703565,325937,128372,84968,45559,1288401
2022,Computer Science,745763,379647,99674,62142,42312,1329538
2020,Computer Science,765334,370650,112357,73007,57557,1378905
2020,Electrical,785964,380744,92578,75158,68008,1402452
2020,Computer Science,625595,467804,82251,56051,44053,1275754
2020,Computer Science,788279,437488,117429,81576,71817,1496589
2020,Mechanical,846661,341512,126871,54115,67890,1437049
2020,Computer Science,764512,389830,105499,69024,34993,1363858
2020,Mechanical,870774,317009,86421,56371,48876,1379451
2022,Computer Science,860300,394353,132204,78690,78381,1543928
2019,Computer Science,839644,495340,104591,89355,38211,1567141
2021,Civil,829820,282548,140940,82420,43515,1379243
2023,Civil,808590,268371,92202,93375,71765,1334303
2021,Mechanical,674191,474971,99290,98002,46335,1392789
2021,Computer Science,700591,458665,98130,96698,32175,1386259
2019,Electrical,663753,355977,117077,59080,32405,1228292
2019,Civil,660520,400716,99396,51883,37341,1249856
2019,Electrical,866152,474731,140848,54821,54284,1590836
2020,Civil,862640,404946,140530,86590,58002,1552708
2022,Civil,885356,469731,144274,58338,55456,1613155
2020,Computer Science,882781,264281,107122,72007,56260,1382451
2022,Civil,720118,449859,109381,52477,73924,1405759
2022,Electrical,814418,403361,125435,63135,45963,1452312
2021,Civil,872028,386126,103267,92423,47989,1501833
2021,Mechanical,716481,350020,141978,60437,48941,1317857
2022,Computer Science,668259,357508,87088,98100,55019,1265974
2022,Computer Science,649810,493482,92822,59502,45779,1341395
2020,Mechanical,729926,316846,130216,79236,48426,1304650
2020,Mechanical,604761,344682,116589,50368,60183,1176583
2021,Mechanical,858414,430841,145262,75839,30778,1541134
2019,Civil,616375,279312,137911,96366,65927,1195891
2022,Computer Science,838117,477589,81436,85515,36395,1519052
2020,Mechanical,761637,364186,141854,57562,64514,1389753
2021,Civil,702654,254257,141888,57139,35974,1191912
2020,Mechanical,895119,396918,107281,77141,35150,1511609
2022,Electrical,758145,403555,133952,92778,42132,1430562
2022,Electrical,800798,276558,102766,56704,79572,1316398
2023,Computer Science,732955,293188,101213,51887,72811,1252054
2019,Civil,780701,394084,142239,61975,48492,1427491
2023,Electrical,795242,283236,102537,99211,67442,1347668
2021,Electrical,674489,485281,82794,50544,66764,1359872
2020,Civil,608381,295076,139204,69448,52466,1164575
2021,Mechanical,744867,298402,112324,72830,39550,1267973
2022,Civil,662999,344467,136764,96323,65394,1305947
2023,Mechanical,769564,413148,110858,73926,63258,1430754
2023,Electrical,751606,330337,122850,81002,39487,1325282
2023,Electrical,619996,365827,93018,97581,40273,1216695
2021,Electrical,803161,456236,130790,63333,60931,1514451
2022,Computer Science,705682,324264,89850,66942,49755,1236493
2020,Computer Science,760477,267335,125975,64684,43684,1262155
2020,Computer Science,857972,293773,145510,76088,56748,1430091
2021,Civil,671325,433230,145696,72447,41366,1364064
2023,Electrical,628930,278570,105832,58861,61863,1134056
2019,Electrical,617529,337995,104886,74833,58329,1193572
2021,Civil,653546,290658,88418,67454,78674,1178750
2021,Computer Science,870086,440256,87081,51050,67757,1516230
2022,Civil,869692,370640,90114,70422,74789,1475657
2020,Computer Science,782088,322613,98722,71530,56525,1331478
2021,Electrical,697780,308194,97985,97060,66148,1267167
2021,Mechanical,862440,448579,85888,65756,68457,1531120
2023,Computer Science,667945,361872,149254,54022,71371,1304464
2023,Electrical,659980,415031,99299,91104,70241,1335655
2019,Electrical,765301,434144,136050,52634,31676,1419805
2022,Mechanical,696382,426660,102036,77145,70558,1372781
2019,Electrical,653444,421605,109346,57288,35282,1276965
2023,Electrical,897180,358558,106691,58992,56222,1477643
2020,Computer Science,860186,318582,97986,84253,43376,1404383
2023,Computer Science,758239,442815,107846,77005,39431,1425336
2022,Mechanical,694527,425590,129665,99824,63370,1412976
2023,Mechanical,683337,393775,121401,62166,31937,1292616
2022,Electrical,672894,299456,130054,78065,54505,1234974
2022,Computer Science,663138,305491,118487,67798,54601,1209515
2022,Mechanical,884732,258043,89412,79301,69580,1381068
2022,Mechanical,683038,353212,131473,53894,59255,1280872
2022,Civil,738709,490003,146553,53846,31067,1460178
2020,Mechanical,869066,318340,85279,64481,43401,1380567
2019,Electrical,693697,391248,87712,92154,68020,1332831
2021,Computer Science,775793,385008,95817,80221,43472,1380311
2019,Mechanical,852097,281174,133832,97764,63147,1428014
2022,Civil,800015,332632,136224,58048,55860,1382779
2020,Computer Science,724338,338768,86624,77386,50131,1277247
2023,Mechanical,627843,375775,109126,83336,35196,1231276
2020,Civil,740118,358177,117462,89258,51516,1356531
2022,Mechanical,827997,275909,138676,73853,52424,1368859
2020,Computer Science,726417,294158,126815,84713,43881,1275984
2020,Computer Science,716585,389438,106093,66791,60593,1339500
2022,Computer Science,630346,466197,112525,54228,74887,1338183
2020,Electrical,819356,435409,109030,61945,71505,1497245
2021,Mechanical,702391,374296,124067,91573,35259,1327586
2021,Electrical,898931,309331,85207,89899,54850,1438218
2020,Computer Science,895727,493990,106639,74681,74401,1645438
2023,Civil,743635,443269,82792,84986,61593,1416275
2022,Mechanical,777132,453114,80420,64975,40461,1416102
2021,Electrical,860609,431996,99198,98377,57684,1547864
2023,Mechanical,721943,409914,115608,57711,65690,1370866
2020,Civil,845534,398530,126205,94759,59824,1524852
2023,Electrical,764762,337367,97875,62105,33387,1295496
2019,Computer Science,825784,315382,101331,99645,51826,1393968
2021,Electrical,614925,324319,96893,80146,44553,1160836
2020,Mechanical,817859,261170,144913,65238,72830,1362010
2022,Mechanical,683184,369952,98243,53868,36959,1242206
2020,Mechanical,676515,330145,95535,94294,72715,1269204
2022,Mechanical,799330,355626,143203,60060,59379,1417598
2020,Computer Science,736427,426014,147394,55433,52674,1417942
2023,Electrical,825407,469643,105489,72612,39559,1512710
2023,Computer Science,700854,266208,93346,67822,62252,1190482
2023,Computer Science,894849,416250,128005,84120,56104,1579328
2019,Computer Science,774981,460244,86773,91004,30551,1443553
2022,Mechanical,819678,390111,112343,71294,30133,1423559
2023,Mechanical,728501,264990,125963,68764,36607,1224825
2019,Mechanical,716361,387513,121983,54560,41103,1321520
2022,Electrical,784811,455293,115972,66583,72973,1495632
2020,Civil,807892,379327,96959,65560,59858,1409596
2019,Mechanical,687273,329314,114133,54424,69367,1254511
2021,Electrical,885385,427031,131150,90615,43372,1577553
2019,Mechanical,650818,276862,101734,76863,67892,1174169
2019,Mechanical,751967,408345,97400,96963,63828,1418503
2022,Computer Science,793481,343949,100002,79469,44048,1360949
2020,Computer Science,718642,423572,116492,87565,60423,1406694
2021,Computer Science,884833,380223,110875,73184,48570,1497685
2023,Electrical,795428,253956,105046,73910,49049,1277389
2023,Civil,824083,453161,103664,97077,65938,1543923
2019,Civil,892988,338789,104453,72404,40919,1449553
2022,Electrical,695687,339451,84746,85175,61680,1266739
2022,Mechanical,885509,367782,93217,53791,79747,1480046
2023,Electrical,737098,252365,143184,82208,78351,1293206
2021,Mechanical,890667,322204,121835,89276,66874,1490856
2020,Electrical,741554,386072,89133,97175,66189,1380123
2021,Electrical,712105,307072,120533,59629,46303,1245642
2020,Electrical,713884,302499,85404,82894,65046,1249727
2023,Civil,706968,319211,113339,71990,47548,1259056
2020,Computer Science,821716,393979,108725,92580,47001,1464001
2022,Electrical,682001,398408,125380,57694,75820,1339303
2019,Civil,639767,335220,128073,86087,62699,1251846
2019,Computer Science,629550,343847,140873,58673,58720,1231663
2023,Computer Science,744905,433403,121341,88199,63218,1451066
2022,Electrical,734042,461744,81236,82187,39990,1399199
2021,Mechanical,698315,359459,147916,54378,42778,1302846
2022,Mechanical,695494,327755,94538,73553,70140,1261480
2019,Mechanical,727424,318783,91971,93780,64660,1296618
2019,Electrical,682681,451023,118655,89258,51912,1393529
2022,Mechanical,780249,433581,140784,72524,76130,1503268
2022,Civil,852411,377851,141289,93331,56798,1521680
2019,Civil,792573,256472,117410,66622,33808,1266885
2021,Civil,628900,403452,131302,51420,39476,1254550
2023,Civil,614126,353152,101703,97440,46606,1213027
2023,Computer Science,711198,408352,124191,50340,58940,1353021
2022,Civil,801762,402931,134112,94310,53337,1486452
2023,Mechanical,818816,480413,91399,90288,53420,1534336
2019,Electrical,816651,429474,92685,93953,59590,1492353
2019,Mechanical,616978,389334,84487,54987,59056,1204842
2022,Civil,656344,392138,92018,76062,31609,1248171
2022,Computer Science,863199,396626,110825,95517,59297,1525464
2022,Civil,675582,257008,87750,82456,57866,1160662
2021,Electrical,832459,337851,138956,88180,63991,1461437
2023,Mechanical,681214,330799,130229,75308,31907,1249457
2022,Electrical,823232,266238,123118,69862,44978,1327428
2020,Electrical,638725,485018,139615,57670,55938,1376966
2020,Electrical,845720,463097,137290,74246,40943,1561296
2019,Mechanical,653333,267153,95105,63766,35810,1115167
2023,Civil,861910,309353,98913,79681,74929,1424786
2022,Electrical,898307,302092,129515,58323,76831,1465068
2020,Mechanical,765043,493907,127342,51857,67705,1505854
2023,Computer Science,796221,424224,132184,97223,52132,1501984
2019,Mechanical,881620,299104,140506,80587,47615,1449432
2021,Computer Science,851831,405355,104967,75818,75028,1512999
2023,Mechanical,800122,427501,116023,75247,39939,1458832
2023,Civil,806598,458295,134288,83272,73518,1555971
2021,Electrical,714832,469606,106622,90235,59954,1441249
2023,Civil,743190,436029,125201,68540,30737,1403697
2019,Mechanical,781601,278887,96350,75837,50820,1283495
2019,Electrical,668682,427244,134820,58484,78703,1367933
2021,Computer Science,823009,254355,128709,80682,72911,1359666
2022,Mechanical,846553,283701,107470,81707,79681,1399112
2020,Electrical,735486,422606,110889,94610,42321,1405912
2022,Computer Science,683030,321442,90224,54923,62567,1212186
2023,Computer Science,720360,442346,85465,92019,34418,1374608
2020,Civil,735009,459180,135214,65920,72164,1467487
2021,Mechanical,898875,262279,82944,93263,31986,1369347
2021,Computer Science,769737,424563,104336,71938,63114,1433688
2020,Electrical,714360,370738,118624,63319,68593,1335634
2019,Computer Science,863894,457219,145206,92161,63983,1622463
2020,Computer Science,665018,389333,124764,56900,76658,1312673
2023,Civil,840904,385546,125420,52160,73728,1477758
2019,Civil,736817,341414,145671,66236,52182,1342320
2021,Electrical,792803,278390,95773,56221,61989,1285176
2020,Civil,686984,407997,106447,75294,63012,1339734
2022,Computer Science,890595,332174,84033,60038,76887,1443727
2022,Computer Science,792608,440123,135852,69651,53442,1491676
2023,Civil,612150,470079,100497,73360,41243,1297329
2022,Computer Science,875550,254787,100978,58255,30132,1319702
2020,Computer Science,750853,492951,92882,52699,45556,1434941
2020,Electrical,788489,454470,96945,93893,47754,1481551
2022,Civil,618325,439249,136485,71928,63855,1329842
2020,Computer Science,799756,293724,148850,98169,39839,1380338
2023,Civil,804541,260663,139870,50372,72851,1328297
2019,Electrical,617669,397192,98595,97312,76183,1286951
2023,Civil,807836,403812,144038,68898,50386,1474970
2023,Computer Science,732915,483118,136126,73855,73220,1499234
2020,Civil,796681,383107,115449,84758,43828,1423823
2019,Computer Science,650812,350271,98639,59607,71078,1230407
2020,Computer Science,878203,438515,125370,89558,65671,1597317
2021,Computer Science,852862,317388,122710,58553,53206,1404719
2020,Electrical,771840,302335,134051,55383,30894,1294503
2020,Civil,625395,293315,140639,98343,31265,1188957
2020,Electrical,882346,445237,83159,50715,52807,1514264
2019,Civil,829707,354922,146988,59837,61143,1452597
2020,Electrical,847181,296627,98706,63950,79514,1385978
2019,Mechanical,804120,389375,89862,57992,39965,1381314
2022,Computer Science,824839,490726,90219,76817,60412,1543013
2021,Computer Science,819882,299334,114536,99803,62229,1395784
2019,Electrical,703235,436964,142886,83818,62748,1429651
2022,Mechanical,645510,442268,113937,63357,71273,1336345
2019,Computer Science,687945,315700,101094,54742,48090,1207571
2019,Civil,842802,289726,107924,63369,70102,1373923
2021,Electrical,850168,481513,80123,55044,58041,1524889
2023,Computer Science,602881,456823,133149,60288,43374,1296515
2023,Computer Science,711860,430678,111854,75378,76116,1405886
2019,Electrical,766415,498045,140796,57261,45375,1507892
2020,Electrical,739728,280694,149432,93614,32393,1295861
2022,Civil,867885,412325,138968,68064,41802,1529044
2020,Civil,747733,405302,120834,59799,66462,1400130
2020,Computer Science,890834,435046,97111,53522,44911,1521424
2019,Computer Science,894977,313545,104099,63690,50064,1426375
2019,Electrical,702566,397997,149206,52057,40655,1342481
2019,Computer Science,671240,256033,130293,85489,71864,1214919
2019,Computer Science,706898,312461,95029,87589,36410,1238387
2023,Electrical,809304,252665,111811,85331,66165,1325276
2019,Computer Science,680522,277025,95793,64559,50381,1168280
2023,Computer Science,745512,404605,128106,63692,75799,1417714
2023,Mechanical,719107,426969,80972,98429,63678,1389155
2019,Civil,622462,327661,80360,50202,52970,1133655
2021,Electrical,879965,370473,82632,83709,56321,1473100
2022,Mechanical,692889,270998,115958,66972,48507,1195324
2020,Civil,688952,311248,98008,91530,48235,1237973
2023,Civil,793596,354493,110283,59537,77683,1395592
2022,Civil,777505,273057,130908,51642,42863,1275975
2021,Mechanical,821576,329244,87818,51365,74725,1364728
2020,Mechanical,819393,464680,110579,90324,31615,1516591
2020,Civil,875455,451703,135178,50008,40582,1552926
2023,Computer Science,854084,347031,137584,99683,57338,1495720
2019,Computer Science,729466,362713,145020,78820,39397,1355416
2021,Mechanical,630531,355887,80975,83803,66794,1217990
2023,Mechanical,614588,317173,143479,95531,59655,1230426
2021,Mechanical,743452,461278,96265,68001,69637,1438633
2019,Civil,773717,288734,143518,56722,73639,1336330
2019,Computer Science,761929,312072,84318,70100,48830,1277249
2023,Mechanical,621711,445247,115081,67460,66080,1315579
2019,Mechanical,736169,484046,138649,73987,38014,1470865
2022,Electrical,759465,444855,123069,54015,67787,1449191
2020,Civil,884220,344194,92427,89897,73061,1483799
2023,Electrical,760389,451811,120251,52962,33216,1418629
2021,Computer Science,658480,468126,105165,54840,51859,1338470
2022,Electrical,869188,432114,147285,70533,50053,1569173
2023,Electrical,850309,433429,144927,70454,41222,1540341
2019,Electrical,655486,389741,104866,98105,48908,1297106
2019,Civil,655162,363272,90282,55699,58693,1223108
2019,Computer Science,810359,317902,100319,55922,53882,1338384
2019,Electrical,629882,372247,116726,74919,43603,1237377
2021,Civil,654078,399982,95412,76508,57883,1283863
2022,Computer Science,838680,306959,104583,71664,43340,1365226
2020,Mechanical,708730,346623,141922,82270,73702,1353247
2021,Electrical,774898,381438,86185,75278,48345,1366144
2021,Computer Science,698938,298415,136389,64862,52687,1251291
2020,Electrical,718319,374716,97423,63598,59581,1313637
2020,Mechanical,632543,371209,131268,51898,67393,1254311
2019,Computer Science,724279,259907,121644,72939,58197,1236966
2021,Civil,629362,485982,116786,81288,38292,1351710
2023,Computer Science,758818,345825,110477,74774,72273,1362167
2020,Civil,842721,282780,83571,52822,33448,1295342
2020,Computer Science,765229,438951,99576,87252,49628,1440636
2022,Civil,742394,466231,142703,75049,44678,1471055
2023,Mechanical,669812,285085,89680,71884,68815,1185276
2023,Mechanical,896161,446571,105706,63052,56477,1567967
2020,Mechanical,828208,270426,144527,68038,31214,1342413
2019,Computer Science,879773,429269,128436,66975,53990,1558443
2022,Mechanical,728614,257485,82774,84616,50010,1203499
2023,Electrical,696950,299527,96972,63269,72326,1229044
2020,Mechanical,774942,445672,94048,53041,70643,1438346
2023,Civil,664829,374604,137602,66551,61564,1305150
2022,Civil,845602,479632,146403,54379,76687,1602703
2022,Civil,610588,496209,107182,57661,77993,1349633
2021,Computer Science,768217,341005,127059,56967,74583,1367831
2020,Electrical,872743,462511,88787,79870,68247,1572158
2022,Mechanical,808502,449820,80393,94967,55078,1488760
2021,Electrical,734011,308528,141775,65674,30172,1280160
2021,Electrical,852856,485551,139454,70394,47270,1595525
2023,Civil,884293,370631,92056,63531,58108,1468619
2023,Civil,797639,277799,141483,71370,46044,1334335
2021,Civil,741280,427411,124957,68565,36263,1398476
2023,Computer Science,797170,397159,108429,50832,50752,1404342
2022,Electrical,780564,388518,125909,96978,41621,1433590
2019,Electrical,620951,431532,132906,67405,72369,1325163
2022,Computer Science,779992,344817,124389,60185,37056,1346439
2021,Computer Science,646766,308260,100905,53492,51337,1160760
2021,Computer Science,759423,395949,133730,94630,44245,1427977
2022,Electrical,687122,405795,137557,50288,62676,1343438
2023,Electrical,871452,262943,146199,90584,78446,1449624
2023,Civil,683211,391378,127301,51076,30260,1283226
2021,Civil,726534,417856,127259,98332,31352,1401333
2020,Electrical,608720,499700,84574,84139,35243,1312376
2023,Civil,679993,371401,136776,51074,72459,1311703
2022,Computer Science,819973,401527,104737,87702,75333,1489272
2023,Mechanical,625905,471099,103390,77535,49390,1327319
2022,Civil,804580,452520,132330,82807,58194,1530431
2021,Electrical,650385,411046,133642,54274,79974,1329321
2023,Civil,630653,277371,101280,78198,60847,1148349
2022,Civil,691865,348746,101037,99334,79683,1320665
2021,Civil,725813,351248,120576,79859,49204,1326700
2020,Mechanical,745871,385008,108564,88264,30166,1357873
2022,Computer Science,791175,414238,108087,95760,51310,1460570
2020,Electrical,848535,275727,92803,85276,75291,1377632
2020,Mechanical,615052,364000,126002,62018,47439,1214511
2019,Electrical,737116,313969,146761,58072,31254,1287172
2023,Electrical,750943,409440,96163,63348,34286,1354180
2022,Electrical,820375,318531,148380,96678,38009,1421973
2020,Mechanical,621381,289097,131885,63952,34007,1140322
2019,Computer Science,748346,416056,116764,98833,44992,1424991
2021,Electrical,843234,300859,142126,50318,70526,1407063
2022,Computer Science,856017,425363,147224,61818,39723,1530145
2020,Computer Science,835020,446300,127055,76011,58104,1542490
2023,Civil,649892,473171,131599,68787,44590,1368039
2019,Mechanical,781593,403222,119720,96750,45638,1446923
2020,Mechanical,814992,403133,124484,93624,75002,1511235
2023,Civil,880064,410250,118852,62516,76779,1548461
2020,Civil,878846,481944,93219,83496,55548,1593053
2022,Computer Science,856216,306790,128865,84055,70657,1446583
2022,Electrical,864038,315696,134457,86769,42016,1442976
2022,Mechanical,893129,265648,116817,58752,78183,1412529
2019,Electrical,759359,311779,148993,51375,34744,1306250
2022,Electrical,858771,356371,132380,64970,54681,1467173
2023,Civil,725702,286672,130400,94846,72564,1310184
2020,Electrical,673527,319109,116258,82792,74733,1266419
2021,Computer Science,746511,441593,128957,67538,67055,1451654
2023,Civil,825692,284593,98281,62657,63770,1334993
2023,Electrical,758731,394858,131331,67843,76357,1429120
2022,Civil,887120,475108,125680,65583,60239,1613730
2019,Computer Science,835311,259815,118723,71491,60894,1346234
2020,Computer Science,798937,403038,90162,87474,60465,1440076
2019,Electrical,799378,394866,131095,96431,42922,1464692
2020,Civil,656697,412495,91338,98612,30084,1289226
2020,Electrical,670382,480552,91675,92180,75783,1410572
2019,Electrical,878795,271302,100080,68540,45373,1364090
2023,Civil,780116,442136,93936,55979,35156,1407323
2020,Electrical,614633,467872,90019,57943,69962,1300429
2019,Computer Science,679164,335140,147282,58911,68551,1289048
2020,Civil,862713,408907,129681,90254,68463,1560018
2021,Civil,723425,323356,84486,83873,75125,1290265
2023,Civil,850220,299282,99112,53769,79305,1381688
2022,Civil,895182,378451,131697,52479,39653,1497462
2020,Electrical,780160,371347,135998,60112,52798,1400415
2021,Electrical,804249,433786,106576,94039,53068,1491718
2022,Computer Science,805538,448107,130100,54731,64787,1503263
2022,Mechanical,797865,273814,101320,61361,55673,1290033
2020,Mechanical,801466,405161,145729,98855,46155,1497366
2019,Computer Science,787223,454234,109144,85940,30570,1467111
2020,Mechanical,711174,436903,137326,96809,70690,1452902
2021,Computer Science,737980,413818,99307,82205,46200,1379510
2022,Electrical,668447,331673,140598,74569,41769,1257056
2020,Civil,805599,301940,99623,57068,68921,1333151
2019,Civil,826301,336796,100249,56557,49075,1368978
2020,Electrical,879778,286476,118377,86098,54053,1424782
2023,Civil,886705,407355,132365,88790,40301,1555516
2019,Civil,655063,382841,114551,95411,35507,1283373
2021,Mechanical,888065,292278,122926,84826,67637,1455732
2022,Electrical,619340,428066,118599,72074,78359,1316438
2020,Mechanical,662781,443970,102593,72155,33655,1315154
2019,Mechanical,877045,265634,140334,86389,46347,1415749
2023,Civil,610638,486107,139893,92105,52053,1380796
2019,Civil,817986,376259,122636,86759,32492,1436132
2023,Electrical,821668,392037,149225,80784,42304,1486018
2021,Civil,894786,408638,120363,82401,69280,1575468
2022,Civil,625378,302196,135959,61565,61403,1186501
2021,Electrical,718171,348679,81120,74700,78011,1300681
2020,Civil,814801,429357,96491,91271,71542,1503462
2019,Mechanical,664377,380861,123638,99926,67118,1335920
2023,Electrical,860339,436571,119062,65337,40882,1522191
2023,Civil,654691,269420,85193,61112,67424,1137840
2019,Computer Science,691782,406308,95213,63761,38511,1295575
2019,Electrical,859896,256218,97187,92791,50699,1356791
2020,Electrical,678343,374283,90040,58885,51178,1252729
2021,Computer Science,721399,430964,146302,51376,47821,1397862
2023,Civil,631357,455103,109949,55939,46415,1298763
2020,Civil,894458,480461,83527,91949,30714,1581109
2021,Electrical,670283,314057,98757,52846,77857,1213800
2020,Electrical,659567,328609,105412,56817,39231,1189636
2023,Civil,837778,457979,94312,57430,46792,1494291
2019,Civil,741758,464202,102119,76328,77931,1462338
2019,Mechanical,661606,392298,91804,61151,78776,1285635
2021,Electrical,881035,373108,133986,77619,37346,1503094
2022,Electrical,701732,433343,126545,84484,70806,1416910
2021,Computer Science,791791,260046,109999,77664,54124,1293624
2022,Mechanical,892021,496027,119758,56780,54048,1618634
2020,Civil,849465,367462,149519,53331,51415,1471192
2020,Mechanical,824589,359345,83768,78604,47511,1393817
2023,Civil,614026,287117,81504,91849,71666,1146162
2022,Civil,882566,379980,147986,67762,42031,1520325
2023,Mechanical,895625,386037,88002,73765,41215,1484644
2019,Electrical,709384,440550,118787,87043,41851,1397615
2022,Civil,852771,492868,93898,71922,63550,1575009
2021,Mechanical,658031,459944,90472,73694,68068,1350209
2019,Computer Science,668232,438349,112632,60556,31178,1310947
2019,Mechanical,743084,466451,113743,63555,32406,1419239
2021,Computer Science,836503,440685,123386,99383,76314,1576271
2019,Civil,892104,267373,123388,60004,49191,1392060
2022,Mechanical,687695,295452,101323,88190,75220,1247880
2023,Mechanical,730066,431161,149269,70810,49148,1430454
2019,Computer Science,738982,256654,121319,61188,61146,1239289
2022,Mechanical,864837,412352,147759,50247,32724,1507919
2020,Mechanical,715313,437213,96868,70762,65303,1385459
2022,Civil,628810,373319,82080,96366,40140,1220715
2023,Mechanical,620092,355646,93776,95995,52684,1218193
2022,Electrical,658105,469015,146231,63811,54240,1391402
2021,Computer Science,761577,448966,135452,53741,49530,1449266
2023,Mechanical,804300,276583,133812,79052,52962,1346709
2020,Computer Science,890699,499105,143271,99214,31201,1663490
2021,Computer Science,671934,344242,138542,84319,40011,1279048
2022,Computer Science,672788,387432,95628,56306,65657,1277811
2023,Mechanical,880083,303968,88265,53005,79796,1405117
2020,Mechanical,755223,384815,104671,53322,40551,1338582
2021,Computer Science,728068,388231,92460,66008,50606,1325373
2020,Electrical,600036,413223,83477,90765,42664,1230165
2022,Computer Science,639051,381590,82202,74870,78472,1256185
2020,Electrical,680738,266652,91850,62466,34320,1136026
2019,Computer Science,660071,459533,100809,95284,33088,1348785
2021,Civil,730613,363114,82806,83161,71456,1331150
2020,Computer Science,673601,495615,87163,52739,72976,1382094
2022,Computer Science,629873,452083,80185,86935,38664,1287740
2022,Mechanical,767720,352489,104718,63194,72848,1360969
2020,Electrical,671468,484537,136202,54231,70693,1417131
2022,Civil,888614,423420,105215,78268,31160,1526677
2023,Electrical,796201,456494,108325,51401,40714,1453135
2023,Civil,608328,327001,98458,58086,34312,1126185
2023,Computer Science,737405,374269,96006,83673,71155,1362508
2019,Mechanical,851519,499625,112969,50529,50845,1565487
2020,Mechanical,721173,326757,107655,90779,49150,1295514
2019,Electrical,646638,274395,89102,73462,65215,1148812
2022,Mechanical,873412,383407,147107,97769,52028,1553723
2019,Electrical,801675,351978,101553,87386,61309,1403901
2022,Electrical,713920,451184,146865,66956,67077,1446002
2022,Civil,771813,494348,121420,67027,73348,1527956
2021,Electrical,607887,381572,105382,97676,71078,1263595
2023,Civil,828978,374541,149235,70455,66264,1489473
2022,Mechanical,624918,473283,118795,89781,64484,1371261
2021,Electrical,897641,258083,131425,92252,57459,1436860
2023,Electrical,792081,356598,137402,94555,51321,1431957
2022,Computer Science,874073,462328,142539,95602,78500,1653042
2022,Electrical,702201,386615,103459,55605,64440,1312320
2019,Electrical,810171,498506,129649,60677,72162,1571165
2019,Computer Science,890690,449884,126384,66938,31455,1565351
2023,Computer Science,809496,433309,136278,96819,44031,1519933
2022,Mechanical,768410,346171,116744,93534,76000,1400859
2020,Electrical,682494,370423,110568,93184,52929,1309598
2019,Mechanical,815859,470788,97991,65009,62137,1511784
2023,Mechanical,833853,256613,88912,80246,79108,1338732
2022,Computer Science,728279,360033,112527,78185,69794,1348818
2022,Civil,681991,447935,130426,79295,59237,1398884
2020,Mechanical,890157,421612,100407,75519,78206,1565901
2023,Civil,652132,326202,92344,70952,66746,1208376
2022,Electrical,855069,407327,82355,96642,32471,1473864
2019,Computer Science,759156,335666,134733,59185,71077,1359817
2020,Electrical,752215,272068,146285,69843,30367,1270778
2023,Electrical,691627,299057,125733,67505,43417,1227339
2020,Computer Science,722772,268946,136915,78022,33374,1240029
2019,Electrical,829415,401619,132716,66439,36773,1466962
2023,Computer Science,741294,335237,118526,64660,44205,1303922
2020,Civil,859013,498196,98088,58849,66580,1580726
2021,Electrical,616116,255769,145377,79628,52369,1149259
2019,Computer Science,782124,405955,124405,74835,48581,1435900
2019,Mechanical,651369,311340,118842,54736,77119,1213406
2019,Electrical,779889,329199,141788,85377,63668,1399921
2021,Civil,833982,354222,131529,97443,46576,1463752
2021,Computer Science,814275,496849,132383,53909,32770,1530186
2022,Electrical,805383,483931,119177,99555,74308,1582354
2020,Electrical,891799,416234,119056,64867,67948,1559904
2022,Electrical,788874,469460,146421,50794,78076,1533625
2020,Civil,647632,466996,113632,67945,69447,1365652
2021,Computer Science,811284,283434,119685,65369,33606,1313378
2021,Mechanical,761848,272102,148590,93601,44678,1320819
2022,Mechanical,791082,271536,88977,73807,63025,1288427
2023,Mechanical,813807,458963,128967,60856,44388,1506981
2022,Computer Science,796523,448842,95070,56795,47034,1444264
2020,Mechanical,779884,354639,101500,79385,73278,1388686
2022,Civil,881039,431460,90011,81063,60920,1544493
2019,Computer Science,835892,300775,128039,88260,65193,1418159
2020,Electrical,813408,281147,88896,98562,45011,1327024
2020,Civil,842718,300526,119958,60149,62347,1385698
2023,Electrical,792879,404731,121912,76669,61254,1457445
2021,Mechanical,623086,490879,80814,76328,63165,1334272
2020,Civil,685637,354663,104719,87767,41106,1273892
2021,Computer Science,758279,463168,100150,87965,51786,1461348
2022,Civil,751969,362180,83825,53562,46944,1298480
2019,Electrical,663083,374233,130368,83623,38381,1289688
2023,Computer Science,695028,273088,94800,92255,71164,1226335
2021,Civil,697551,318464,128505,86389,41207,1272116
2020,Civil,738355,355921,137899,54206,58715,1345096
2021,Civil,694024,309998,102601,83806,33371,1223800
2020,Civil,862399,290382,90677,87364,61359,1392181
2021,Computer Science,807627,278184,109552,70897,65809,1332069
2020,Electrical,615487,401171,147891,64151,36844,1265544
2022,Civil,619346,450882,113292,54370,72665,1310555
2020,Computer Science,897194,471578,146097,74045,51782,1640696
2020,Electrical,870888,472352,96184,71700,79864,1590988
2019,Civil,661596,287739,141046,86215,66224,1242820
2020,Electrical,814469,377937,146741,72234,40876,1452257
2019,Electrical,777175,389461,141377,98671,53331,1460015
2023,Computer Science,753048,267352,92039,65326,67174,1244939
2019,Electrical,606277,376788,125161,96824,75933,1280983
2022,Computer Science,733332,367843,115006,87997,74559,1378737
2019,Civil,840515,402220,97544,52241,43144,1435664
2023,Electrical,860577,281828,92987,80639,37649,1353680
2022,Electrical,796955,318040,85239,90586,66645,1357465
2021,Mechanical,886885,437867,124785,89766,68419,1607722
2021,Civil,899355,439692,103358,71278,42818,1556501
2019,Civil,840464,485382,136450,92923,66880,1622099
2019,Mechanical,858445,344279,108428,56444,61773,1429369
2023,Mechanical,869013,344430,89096,53015,67333,1422887
2023,Computer Science,694515,477603,127582,64903,55130,1419733
2020,Computer Science,750494,438186,104536,89583,56716,1439515
2023,Electrical,766685,421783,137395,78143,67745,1471751
2020,Electrical,788088,365957,148157,54864,61297,1418363
2022,Electrical,660110,267748,149484,59676,49062,1186080
2019,Electrical,819601,338636,81287,54234,59492,1353250
2022,Computer Science,808994,414763,134510,71340,71543,1501150
2023,Civil,896177,365158,103902,96915,51325,1513477
2022,Electrical,860705,469589,136188,68723,40188,1575393
2022,Civil,612938,446354,101164,58526,30841,1249823
2022,Electrical,730842,479316,81772,56842,40567,1389339
2023,Mechanical,864418,441432,133054,84626,66806,1590336
2022,Electrical,750033,260246,134878,51207,64572,1260936
2020,Electrical,620044,491851,112238,67308,38921,1330362
2023,Electrical,699372,309395,138293,55429,34349,1236838
2022,Computer Science,876850,413558,87213,57591,39655,1474867
2023,Mechanical,737046,411412,94941,95712,77674,1416785
2021,Electrical,621213,465946,95964,88660,44879,1316662
2020,Electrical,601950,300300,106855,61777,34946,1105828
2022,Civil,854043,384158,138769,88713,73127,1538810
2021,Mechanical,816085,472143,81046,90459,53502,1513235
2021,Electrical,872555,264860,94909,62548,59493,1354365
2023,Civil,748843,267013,103368,96441,36657,1252322
2021,Civil,897197,388479,95624,86795,78757,1546852
2020,Computer Science,848966,283542,90352,95224,43266,1361350
2020,Civil,738117,274935,89223,87063,36240,1225578
2019,Electrical,629714,488085,146851,82055,51350,1398055
2020,Computer Science,765458,299079,130044,62869,72353,1329803
2021,Computer Science,870706,284111,111419,73863,78544,1418643
2020,Electrical,612026,306550,93767,54661,46640,1113644
2023,Mechanical,706147,456769,111028,97498,62895,1434337
2019,Civil,631589,470189,127953,94802,72342,1396875
2021,Computer Science,708199,478885,137965,68782,59851,1453682
2019,Mechanical,888988,468008,149776,99179,41920,1647871
2021,Electrical,808574,326955,111459,94910,44392,1386290
2023,Civil,814340,290565,104689,51898,44917,1306409
2019,Civil,654708,269283,147982,62919,60643,1195535
2022,Computer Science,670825,316470,83346,90068,59227,1219936
2021,Civil,651574,481362,125179,52427,53251,1363793
2022,Civil,832409,336916,120517,84393,54238,1428473
2019,Civil,786381,329552,149678,60767,57723,1384101
2022,Civil,664230,288233,138916,68420,64973,1224772
2022,Electrical,854451,272695,128575,86123,58756,1400600
2019,Mechanical,847174,471560,125039,96821,38513,1579107
2023,Electrical,819700,376440,129955,54902,73316,1454313
2022,Electrical,887249,423806,135871,76850,60225,1584001
2022,Computer Science,846514,331257,140678,98554,34379,1451382
2023,Civil,864491,251505,111351,93034,70835,1391216
2022,Electrical,826094,386435,140693,71620,41305,1466147
2022,Civil,748182,429780,111433,58280,61722,1409397
2022,Electrical,793242,293614,95804,64954,42148,1289762
2020,Electrical,782873,251010,125101,94764,42901,1296649
2023,Computer Science,724926,494300,140115,96814,40888,1497043
2022,Mechanical,681147,492858,124700,96973,60099,1455777
2023,Mechanical,619199,380560,99477,87729,72476,1259441
2021,Electrical,783208,400933,96127,82800,74253,1437321
2021,Computer Science,820868,405197,106049,87466,50708,1470288
2022,Civil,720787,390441,92473,58887,76885,1339473
2023,Civil,714427,319393,141836,81607,57621,1314884
2023,Electrical,748063,407743,122464,82141,60001,1420412
2023,Mechanical,753625,456472,93714,91484,62571,1457866
2020,Computer Science,820782,314512,140878,63335,44220,1383727
2021,Mechanical,687493,348026,114208,56177,54694,1260598
2023,Civil,874915,325656,121514,91206,46221,1459512
2023,Mechanical,725607,466831,85136,53926,69849,1401349
2020,Civil,846834,347686,111516,98146,32371,1436553
2020,Computer Science,679876,425210,143878,93056,67784,1409804
2023,Computer Science,767071,434492,125099,60154,69070,1455886
2019,Electrical,802959,449161,93188,52959,69150,1467417
2023,Electrical,843722,265489,131188,68611,75375,1384385
2023,Mechanical,644440,309789,85560,84161,74220,1198170
2020,Computer Science,631655,319925,116397,68407,52836,1189220
2020,Computer Science,643039,299703,118082,63025,57161,1181010
2023,Electrical,672219,468558,121430,56064,51180,1369451
2023,Civil,786061,326625,130522,56639,45865,1345712
2023,Mechanical,873388,357535,120397,52478,48825,1452623
2020,Mechanical,694594,439300,105247,57929,57275,1354345
2023,Electrical,770623,253051,99943,82326,31017,1236960
2023,Computer Science,794302,419162,119460,72837,50885,1456646
2022,Electrical,890515,278805,121986,91941,65815,1449062
2019,Electrical,759950,344978,124514,79974,76260,1385676
2021,Electrical,767229,294557,132385,94183,40260,1328614
2019,Electrical,605914,383627,92631,58418,76662,1217252
2022,Civil,814772,300241,147008,67650,41857,1371528
2021,Civil,889324,459375,106955,84825,67018,1607497
2023,Computer Science,827561,377838,127367,96471,59230,1488467
2022,Electrical,787435,315994,110802,64383,54769,1333383
2023,Civil,695213,364005,123341,96703,70159,1349421
2020,Computer Science,637805,266066,93691,93211,65214,1155987
2022,Electrical,726599,385793,84753,81708,62492,1341345
2020,Mechanical,753775,327982,81833,85709,53507,1302806
2022,Civil,790093,256304,88645,82924,73479,1291445
2022,Computer Science,674176,492941,120024,73382,52679,1413202
2020,Mechanical,694799,292967,89635,76649,74887,1228937
2021,Electrical,698385,481296,100064,81140,33687,1394572
2019,Electrical,835654,328763,89940,95023,79135,1428515
2023,Electrical,688919,290462,115169,82563,37864,1214977
2022,Civil,681462,370356,125200,80373,36127,1293518
2023,Computer Science,779340,321834,136329,67144,59473,1364120
2020,Mechanical,765320,486005,131158,58965,79704,1521152
2023,Computer Science,631159,361023,109739,72791,43834,1218546
2020,Civil,642039,484522,97793,73115,38921,1336390
2023,Computer Science,832974,431227,113677,67341,58573,1503792
2019,Civil,647800,367771,146296,97573,67876,1327316
2019,Electrical,694626,325842,103022,66637,34266,1224393
2019,Mechanical,718368,252589,107265,74269,67713,1220204
2019,Electrical,774735,375023,80530,67953,38985,1337226
2019,Computer Science,680903,418150,89551,77794,52068,1318466
2019,Electrical,718998,481617,108394,73877,54700,1437586
2020,Mechanical,841324,304918,122987,90273,38366,1397868
2022,Electrical,833229,394673,128984,62405,65319,1484610
2023,Mechanical,661748,257711,148096,77812,33848,1179215
2019,Mechanical,641190,467972,104090,95605,60472,1369329
2020,Electrical,640318,309430,82781,91767,33456,1157752
2020,Civil,768090,444399,97330,59973,49142,1418934
2020,Computer Science,724078,480314,85257,73925,42031,1405605
2022,Civil,639759,476218,138642,94623,50139,1399381
2023,Civil,878642,352605,134249,73091,50026,1488613
2022,Electrical,625989,253970,131663,69584,70887,1152093
2021,Computer Science,756640,319535,114956,89325,58777,1339233
2020,Computer Science,761171,336570,95615,59071,72930,1325357
2021,Civil,885626,371315,80881,55088,31660,1424570
2019,Electrical,892192,417248,81847,99152,57151,1547590
2019,Computer Science,635814,362111,131127,66550,54613,1250215
2022,Civil,790766,291730,117336,52063,59066,1310961
2023,Computer Science,660204,463240,119931,77280,43208,1363863
2021,Electrical,632844,394457,123924,58303,73484,1283012
2023,Electrical,848827,373252,102966,61631,75777,1462453
2022,Electrical,845256,387022,124023,51125,49960,1457386
2019,Computer Science,621518,482302,91320,85409,60702,1341251
2023,Mechanical,623052,454583,137841,72485,52842,1340803
2023,Computer Science,856346,434081,145125,93003,41727,1570282
2019,Mechanical,669803,467922,147752,62794,76689,1424960
2021,Electrical,671524,404470,141858,68018,62389,1348259
2019,Civil,824582,406349,138714,58862,56804,1485311
2023,Mechanical,667021,407833,91780,85879,43021,1295534
2021,Electrical,811321,445507,81929,51690,74001,1464448
2021,Electrical,882187,313944,94244,65740,49092,1405207
2019,Mechanical,602419,412605,91116,97862,58915,1262917
2023,Civil,787964,453574,115895,98643,75368,1531444
2022,Electrical,721831,357437,103867,73024,40501,1296660
2023,Mechanical,844688,376794,81208,70341,71190,1444221
2020,Civil,701799,322123,124085,59156,45739,1252902
2022,Civil,794941,272880,145572,99432,73653,1386478
2021,Electrical,776282,451699,145234,87214,37476,1497905
2022,Computer Science,708611,422825,91252,81053,37931,1341672
2021,Computer Science,737559,477738,87006,60158,43699,1406160
2021,Electrical,662112,463669,112171,52808,32804,1323564
2022,Civil,839040,337829,108517,55402,78904,1419692
2021,Electrical,878504,382633,104274,51964,79993,1497368
2021,Mechanical,833451,303205,113577,67206,68343,1385782
2020,Computer Science,821490,356948,107648,59629,41775,1387490
2023,Mechanical,865161,309810,149654,82337,73449,1480411
2023,Electrical,791196,363089,97910,84829,77686,1414710
2020,Electrical,847418,314482,129647,71559,75874,1438980
2022,Civil,821370,319192,80424,53865,61586,1336437
2019,Civil,789340,337154,131899,54294,30607,1343294
2019,Civil,666320,336066,106641,96939,61629,1267595
2019,Mechanical,835067,468480,114750,62965,67386,1548648
2020,Civil,812373,409402,103154,62228,44089,1431246
2020,Electrical,893271,397211,128166,98419,78336,1595403
2021,Civil,780786,378514,91992,81377,59708,1392377
2019,Computer Science,894065,282977,114001,99229,67025,1457297
2022,Civil,866890,254983,94546,84927,78699,1380045
2022,Mechanical,665350,420981,121524,62822,78562,1349239
2019,Computer Science,781417,489494,148555,80070,40223,1539759
2019,Computer Science,840678,445552,81304,53187,79353,1500074
2019,Computer Science,622063,299029,129284,57135,52943,1160454
2020,Mechanical,717116,402401,90022,63508,51515,1324562
2020,Electrical,777043,372668,113617,83557,59619,1406504
2020,Civil,734670,417806,149498,84090,64132,1450196
2023,Computer Science,610564,292837,138824,96155,30751,1169131
2022,Computer Science,842124,455426,114307,89441,76005,1577303
2022,Computer Science,827506,457526,148480,89884,77476,1600872
2021,Electrical,686134,489026,102327,76067,70313,1423867
2020,Electrical,705940,367512,83244,68043,35344,1260083
2023,Mechanical,662085,316786,102720,80572,63973,1226136
2023,Electrical,617862,254758,105090,59507,39512,1076729
2022,Civil,872409,352667,144277,53062,66655,1489070
2020,Mechanical,740777,448771,128536,74700,64098,1456882
2021,Mechanical,786351,358119,87855,68454,38622,1339401
2020,Civil,662471,350157,81601,60868,67451,1222548
2019,Civil,691080,332673,111952,52553,48658,1236916
2020,Civil,708007,347639,130374,79553,66133,1331706
2019,Mechanical,646104,402904,85690,78511,47647,1260856
2019,Mechanical,640934,382940,92521,67428,50620,1234443
2021,Mechanical,854606,364869,88058,92747,67067,1467347
2022,Civil,606050,431737,93704,55957,33733,1221181
2020,Civil,775024,494944,138933,94495,59675,1563071
2019,Computer Science,870628,422934,123856,54578,31665,1503661
2020,Electrical,784750,269728,117256,88389,30860,1290983
2022,Computer Science,631323,353542,137352,84734,79996,1286947
2022,Civil,686332,343565,110615,60548,57618,1258678
2023,Mechanical,855540,420929,81927,71353,57916,1487665
2022,Civil,854547,409255,95512,96632,41681,1497627
2021,Electrical,872459,469393,88301,68634,46520,1545307
2019,Computer Science,757591,400012,148759,61679,52131,1420172
2023,Computer Science,871251,375019,143058,97743,52878,1539949
2021,Mechanical,655781,386352,144926,74717,41424,1303200
2020,Computer Science,866013,352548,103434,96935,68554,1487484
2019,Computer Science,607971,383236,110341,75579,56796,1233923
2022,Civil,854927,371289,95007,76730,39345,1437298
2019,Computer Science,887795,473796,106799,84782,57486,1610658
2020,Computer Science,623446,494525,135820,54624,52584,1360999
2023,Computer Science,857419,379068,95674,73103,56986,1462250
2023,Mechanical,769180,329624,95426,75544,41598,1311372
2023,Mechanical,603823,399477,124791,78534,38325,1244950
2022,Civil,744526,252821,83255,88636,48445,1217683
2021,Computer Science,735004,305090,113826,97394,67146,1318460
2021,Mechanical,805162,403588,84944,83572,73813,1451079
2019,Mechanical,667965,391545,117826,78560,33730,1289626
2022,Civil,872654,296454,110497,83435,41684,1404724
2023,Electrical,741609,423602,107723,83152,68890,1424976
2023,Computer Science,705935,354273,115287,94084,64563,1334142
2020,Mechanical,833705,458786,91845,69638,40041,1494015
2020,Civil,853978,354472,148106,86208,38187,1480951
2023,Civil,744854,473626,135569,66396,67608,1488053
2023,Civil,678004,463705,105463,90494,62624,1400290
2022,Mechanical,622072,460704,80744,93967,40919,1298406
2021,Computer Science,681015,486579,116282,76783,33726,1394385
2020,Electrical,825075,450153,132082,55403,61716,1524429
2021,Computer Science,820010,405870,134689,73838,63027,1497434
2022,Civil,672746,381935,144766,88919,31843,1320209
2023,Civil,776774,266148,145711,62359,43754,1294746
2021,Electrical,728259,336545,83217,97995,58853,1304869
2023,Computer Science,630916,304459,110359,72614,32280,1150628
2023,Civil,627268,464417,133509,60057,55531,1340782
2019,Civil,775050,334224,141970,50100,59788,1361132
2021,Computer Science,843966,316189,102357,78655,37796,1378963
2021,Civil,623259,389201,122354,54978,34567,1224359
2023,Computer Science,679400,341954,118570,92272,60211,1292407
2022,Civil,896437,273118,87034,60988,39300,1356877
2019,Computer Science,711581,381515,96263,64531,62150,1316040
2023,Electrical,607043,408113,122180,89302,31255,1257893
2020,Civil,781502,339379,130099,99601,61828,1412409
2020,Electrical,707009,271053,106925,61631,36462,1183080
2019,Civil,809137,346384,99575,61693,73200,1389989
2022,Civil,761940,484482,102231,85935,48042,1482630
2023,Mechanical,888453,418276,127731,88148,57560,1580168
2021,Computer Science,885428,367545,103100,63823,49032,1468928
2019,Electrical,713259,423312,90768,74696,77710,1379745
2022,Electrical,700804,482415,139337,61629,42150,1426335
2021,Electrical,669000,376675,130697,53856,33371,1263599
2020,Computer Science,684179,343749,91357,81051,49813,1250149
2020,Mechanical,891409,442174,146973,51075,37620,1569251
2021,Electrical,860226,389363,104946,98523,32932,1485990
2019,Computer Science,623880,489654,135149,70797,51470,1370950
2020,Civil,801264,266285,85566,93682,39778,1286575
2023,Electrical,772438,473494,121576,83469,53033,1504010
2021,Electrical,845352,311589,133318,86116,40304,1416679
2021,Mechanical,667396,263944,149550,58185,38119,1177194
2020,Electrical,879250,351041,131408,77841,77325,1516865
2019,Electrical,656731,338876,133506,56836,44407,1230356
2023,Civil,675010,345561,120167,96072,34983,1271793
2019,Computer Science,849091,304391,113699,74596,32521,1374298
2022,Computer Science,894743,251607,129545,93406,49086,1418387
2022,Mechanical,671326,252953,132429,72218,79170,1208096
2020,Civil,848876,294941,103386,85017,79111,1411331
2020,Computer Science,609004,452541,139273,60705,30783,1292306
2020,Civil,715018,457994,121585,69606,72666,1436869
2022,Computer Science,625792,311683,87509,71375,46798,1143157
2019,Civil,654645,494597,143305,92142,38555,1423244
2019,Mechanical,607232,451290,122851,76933,40767,1299073
2020,Electrical,654766,494229,114407,58118,31103,1352623
2023,Mechanical,720601,359588,126606,85319,35309,1327423
2019,Computer Science,681588,372080,125652,76649,63939,1319908
2022,Mechanical,779614,261154,90248,95318,38634,1264968
2021,Electrical,605913,375542,90515,52214,69176,1193360
2021,Mechanical,712406,390119,90830,58534,42135,1294024
2021,Computer Science,713693,338529,140631,99869,62044,1354766
2023,Computer Science,693449,456946,86799,85228,50945,1373367
2020,Mechanical,610567,264323,94328,94696,76478,1140392
2022,Electrical,638379,287693,92679,53255,69404,1141410
2023,Mechanical,806040,439802,101058,77841,32589,1457330
2022,Electrical,862463,339170,126696,55334,40031,1423694
2022,Civil,690005,407364,118872,62281,39695,1318217
2020,Electrical,823098,485159,134971,89598,45527,1578353
2021,Civil,604791,295111,103306,90522,35722,1129452
2020,Mechanical,731401,456525,108210,89708,76170,1462014
2023,Electrical,805459,456753,125693,80697,79874,1548476
2023,Civil,661032,476325,108239,60722,30841,1337159
2023,Civil,775150,289491,148917,86400,48731,1348689
2020,Civil,621300,299336,87447,66029,30645,1104757
2022,Computer Science,655609,266905,100271,50014,62116,1134915
2022,Mechanical,791634,280273,145875,94349,70983,1383114
2019,Civil,690045,375191,136843,96925,59402,1358406
2023,Electrical,867847,365936,106221,61506,79158,1480668
2022,Civil,823717,407306,144388,58208,61749,1495368
2019,Computer Science,819162,459957,136467,77157,66469,1559212
2022,Mechanical,627676,316538,123086,59971,43908,1171179
2023,Computer Science,820412,354570,80638,91040,72231,1418891
2021,Computer Science,776512,413645,142934,73183,75221,1481495
2023,Computer Science,767995,343339,146760,72963,42715,1373772
2020,Electrical,891946,371132,127234,85847,68398,1544557
2022,Mechanical,724786,445392,141049,58127,78670,1448024
2022,Mechanical,668147,378993,143843,91978,65324,1348285
2020,Electrical,622075,261330,128047,97782,49338,1158572
2020,Mechanical,805788,473112,89741,65646,37387,1471674
2021,Computer Science,609304,461588,143004,75355,53172,1342423
2022,Mechanical,729851,322553,141489,68208,56175,1318276
2022,Electrical,659622,422425,102991,72713,60795,1318546
2021,Computer Science,708654,397083,106081,82267,72626,1366711
2019,Electrical,849109,333537,137304,53864,76398,1450212
2021,Civil,886172,310985,95642,60661,67429,1420889
2023,Computer Science,639328,267044,97399,82559,33801,1120131
2022,Computer Science,889445,419364,113103,60322,37413,1519647
2020,Mechanical,818348,372304,95330,56710,74839,1417531
2023,Computer Science,636845,386322,96464,81362,47665,1248658
2022,Electrical,676394,486888,82134,82380,40856,1368652
2021,Mechanical,775231,273289,129409,91284,61100,1330313
2023,Civil,680722,283087,80184,64386,73855,1182234
2022,Electrical,887374,325952,129274,63338,38187,1444125
2019,Civil,692554,471767,135810,65316,55784,1421231
2019,Civil,649262,286368,149050,74463,79454,1238597
2020,Civil,641722,370648,112734,60203,43805,1229112
2022,Computer Science,771231,320815,130546,54888,71715,1349195
2019,Electrical,840740,340693,115120,78192,72186,1446931
2021,Electrical,687052,442112,128484,61325,37575,1356548
2022,Computer Science,700808,497527,140563,69088,72193,1480179
2021,Mechanical,855416,308900,135113,59386,68746,1427561
2021,Civil,862128,265494,133096,98413,77204,1436335
2019,Electrical,821281,366486,90133,89028,58093,1425021
2022,Computer Science,846052,426238,86405,61267,39089,1459051
2023,Civil,704697,472182,110269,81809,59454,1428411
2019,Mechanical,831572,406405,97085,65419,52474,1452955
2019,Mechanical,832842,283050,115702,75480,38154,1345228
2022,Civil,696299,347799,93502,95854,70951,1304405
2022,Mechanical,765746,381016,126479,52904,52064,1378209
2021,Electrical,749177,479147,94426,94260,57886,1474896
2022,Electrical,760811,460638,95860,83891,59398,1460598
2021,Electrical,763041,338257,126865,63430,66130,1357723
2019,Mechanical,614497,298070,127404,64999,73869,1178839
2020,Electrical,854204,255166,137423,73319,39646,1359758
2023,Computer Science,857471,388193,111152,70700,55391,1482907
2019,Electrical,692019,395749,110737,77633,58822,1334960
2022,Electrical,790326,437633,134325,69108,78523,1509915
2023,Mechanical,709017,477849,118767,90889,67872,1464394
2020,Electrical,818220,462981,121705,74055,51999,1528960
2020,Civil,705153,337409,82002,68642,39512,1232718
2021,Computer Science,633826,287664,140237,53646,59340,1174713
2023,Mechanical,710034,379926,135713,63173,46069,1334915
2021,Computer Science,684242,495890,121815,57025,79074,1438046
2019,Civil,650100,251293,144997,62549,79023,1187962
2023,Mechanical,821171,403515,140859,64853,34502,1464900
2019,Mechanical,612809,486333,143236,91757,62236,1396371
2021,Electrical,664450,299212,102743,79952,78020,1224377
2023,Computer Science,711126,465203,136739,61326,54007,1428401
2021,Civil,864237,325276,110339,53463,50971,1404286
2023,Civil,644498,262559,114121,77163,36037,1134378
2021,Mechanical,716251,315231,122995,82600,72060,1309137
2020,Electrical,640985,358277,132032,97156,57361,1285811
2021,Mechanical,894153,420116,129831,64075,44466,1552641
2020,Mechanical,617718,271747,121446,78709,63764,1153384
2021,Mechanical,878849,487528,125678,93315,60583,1645953
2023,Mechanical,662598,454581,100698,87709,39627,1345213
2023,Civil,874383,461941,127918,66010,51593,1581845
2023,Civil,646665,411201,137235,50897,50084,1296082
2022,Mechanical,894418,250037,86125,91012,53149,1374741
2019,Mechanical,746075,354294,127511,50605,67752,1346237
2023,Electrical,761938,347847,109046,86445,46737,1352013
2020,Mechanical,753060,353742,90114,87315,32318,1316549
2023,Civil,821516,298503,80637,58652,76471,1335779
2022,Computer Science,736746,278207,118634,99926,75487,1309000
2020,Civil,801610,490232,115776,82229,55314,1545161
2022,Electrical,666446,283241,103600,80530,65287,1199104
2020,Civil,629072,381130,106809,88024,60451,1265486
2021,Computer Science,633717,449244,103756,99101,35427,1321245
2019,Mechanical,818417,346171,139469,70414,67371,1441842
2019,Computer Science,757723,395906,118368,77903,54630,1404530
2022,Mechanical,709525,462185,91880,64730,63667,1391987
2019,Mechanical,813092,367302,137155,87924,56678,1462151
2022,Civil,604646,408262,145316,88541,55099,1301864
2022,Civil,775403,322832,88727,77898,61634,1326494
2022,Civil,884329,271383,119211,93654,46846,1415423
2019,Electrical,829728,492046,121417,65930,47885,1557006
2022,Civil,652107,374291,142827,53518,42068,1264811
2019,Electrical,844865,405732,111437,80982,47099,1490115
2022,Civil,879707,489101,100519,56775,68098,1594200
2023,Mechanical,670729,499557,87983,73990,57873,1390132
2022,Electrical,877845,252674,124656,55378,53558,1364111
2020,Computer Science,800144,364100,85635,96402,60518,1406799
2022,Electrical,815494,359369,99622,89441,39180,1403106
2021,Electrical,852615,272820,140666,56444,46595,1369140
2022,Computer Science,728331,466112,136005,64176,53740,1448364
2020,Electrical,760482,406738,91403,75060,57722,1391405
2020,Mechanical,699280,293794,140477,59379,79905,1272835
2019,Civil,789787,383148,145035,86495,78241,1482706
2023,Computer Science,638665,445926,112903,96993,33750,1328237
2022,Civil,878101,378544,87311,77568,41881,1463405
2019,Mechanical,859285,433414,130611,72765,49606,1545681
2023,Computer Science,763947,287555,100615,80802,46819,1279738
2022,Civil,713828,436280,136808,73196,56477,1416589
2021,Civil,732698,282406,113580,65468,58755,1252907
2022,Mechanical,690815,442644,137052,78849,55811,1405171
2020,Civil,794894,290262,122898,87113,67697,1362864
2020,Mechanical,803485,341320,103952,58174,77564,1384495
2021,Electrical,764714,499337,95227,95820,48344,1503442
2019,Mechanical,632356,467733,93760,69098,50656,1313603
2023,Electrical,865953,404288,88826,57046,56382,1472495
2022,Computer Science,897019,449189,140432,54186,61031,1601857
2020,Civil,841121,462208,138204,66722,35813,1544068
2019,Mechanical,871609,280284,88673,92621,31724,1364911
2021,Mechanical,797167,401243,116158,55968,31494,1402030
2020,Civil,796322,340627,95904,95224,48363,1376440
2021,Civil,615250,395405,95396,98266,51812,1256129
2022,Computer Science,646023,411607,134039,90452,50437,1332558
2023,Computer Science,701350,339023,84334,78270,71205,1274182
2020,Mechanical,777696,457012,107268,98311,60524,1500811
2020,Computer Science,616427,490542,144636,91129,37160,1379894
2022,Electrical,810084,414772,102068,89273,71343,1487540
2019,Computer Science,734511,464655,108247,56387,53593,1417393
2023,Computer Science,818403,291516,145121,74394,30284,1359718
2020,Mechanical,678672,265577,96285,61291,78083,1179908
2023,Electrical,617300,470906,104136,95574,67851,1355767
2020,Computer Science,619659,265015,140378,80093,50378,1155523
2023,Electrical,762475,341104,117787,52610,38491,1312467
2021,Electrical,845259,364412,104425,85241,30900,1430237
2020,Electrical,610360,341740,98961,78337,31459,1160857
2023,Civil,883568,478356,113443,85456,43680,1604503
2019,Civil,698035,472875,98823,54804,49305,1373842
2021,Civil,648791,402308,105852,84058,65301,1306310
2021,Civil,799867,479223,117535,60227,62692,1519544
2019,Mechanical,874444,316640,87004,81334,69347,1428769
2023,Computer Science,633370,333190,107823,56511,47189,1178083
2022,Civil,800903,379516,134086,90965,37595,1443065
2019,Mechanical,627209,426776,87131,91482,48612,1281210
2023,Computer Science,883071,423441,105649,89440,31921,1533522
2019,Civil,634579,384718,84099,69727,67740,1240863
2019,Computer Science,871176,337007,130806,99217,32387,1470593
2020,Civil,693254,406978,111571,81139,40730,1333672
2023,Mechanical,713528,467715,110580,69794,44830,1406447
2022,Electrical,823274,297728,106469,52981,64764,1345216
2020,Electrical,838292,264878,145179,62785,34825,1345959
2019,Computer Science,781026,497814,104236,64666,35282,1483024
2019,Mechanical,848342,378925,105110,85583,43869,1461829
2019,Electrical,819437,259145,103430,55096,45451,1282559
2023,Civil,878076,338578,124407,63950,62872,1467883
2023,Electrical,887858,268226,117948,56673,71398,1402103
2020,Computer Science,657803,252802,137367,51742,47905,1147619
2022,Computer Science,733624,274119,118180,88488,64119,1278530
2020,Mechanical,656627,313560,84652,86277,32698,1173814
2021,Computer Science,777059,307353,87084,95041,49996,1316533
2019,Electrical,645380,495741,125630,53534,46892,1367177
2019,Electrical,760322,473793,133276,64685,78068,1510144
2019,Electrical,799416,373001,82655,55136,68078,1378286
2020,Electrical,746367,443198,137752,55585,36190,1419092
2020,Mechanical,872667,321641,127670,77358,43166,1442502
2019,Civil,859125,301712,85272,58554,59689,1364352
2020,Civil,613769,433261,80218,94241,65590,1287079
2023,Mechanical,712035,438856,117471,51634,61604,1381600
2023,Computer Science,775717,380085,128762,66908,79215,1430687
2020,Civil,821815,318285,101515,71310,33921,1346846
2019,Computer Science,831832,365278,114307,65117,58991,1435525
2020,Civil,756629,497128,97986,51722,47243,1450708
2020,Computer Science,834799,424021,134888,58611,73787,1526106
2020,Mechanical,768157,415201,91603,53864,64315,1393140
2021,Electrical,744542,274512,148024,51067,62035,1280180
2023,Computer Science,718643,352077,108897,75976,64844,1320437
2022,Electrical,810154,460103,98802,89206,76730,1534995
2022,Computer Science,737877,444626,96411,57271,46820,1383005
2021,Computer Science,813396,252064,140399,94093,52469,1352421
2020,Computer Science,825956,345614,140692,61828,76676,1450766
2021,Computer Science,781844,432639,137676,96900,66425,1515484
2021,Computer Science,701422,367639,92770,81131,79914,1322876
2019,Electrical,868774,280011,117429,70386,30735,1367335
2023,Computer Science,877845,321152,139429,99781,37214,1475421
2022,Electrical,745931,454583,100337,96210,53968,1451029
2020,Mechanical,717556,260960,104507,51834,74624,1209481
2022,Civil,828495,474600,139596,97894,66862,1607447
2022,Computer Science,854809,371789,88436,52353,34728,1402115
2023,Civil,805384,308920,90086,63878,66497,1334765
2022,Electrical,615021,271387,99851,61132,37241,1084632
2022,Mechanical,800935,396396,119732,58203,47460,1422726
2021,Mechanical,804222,313960,94842,60322,40472,1313818
2023,Mechanical,664361,372994,81745,61295,64598,1244993
2019,Civil,872499,452851,92697,85925,72858,1576830
2020,Electrical,698841,282628,83879,72247,47057,1184652
2022,Computer Science,780076,371269,98499,92394,79700,1421938
2020,Computer Science,846300,456168,115035,67340,44432,1529275
2019,Electrical,760786,297452,98651,70242,63663,1290794
2020,Civil,617198,291098,117249,72522,48953,1147020
2019,Computer Science,858466,451531,103849,94594,47297,1555737
2021,Electrical,618740,420307,109076,62095,70041,1280259
2022,Computer Science,865954,336861,113124,96335,36696,1448970
2019,Mechanical,858308,277949,95787,90652,59347,1382043
2020,Computer Science,699855,403893,133462,73425,51249,1361884
2022,Civil,810192,452684,83841,84723,49657,1481097
2021,Electrical,888927,403104,124890,60204,52960,1530085
2022,Civil,721701,323537,105402,54991,77810,1283441
2019,Electrical,871615,396375,146201,81626,77668,1573485
2021,Mechanical,710771,366003,103237,86833,75202,1342046
2020,Electrical,606163,463065,122988,66067,47906,1306189
2021,Computer Science,616065,488051,80553,63763,70245,1318677
2021,Computer Science,841262,393375,93860,94863,32802,1456162
2023,Mechanical,848924,300701,87045,67408,65890,1369968
2021,Electrical,779420,300511,136435,75176,75550,1367092
2021,Mechanical,881298,330664,112261,85097,65224,1474544
2022,Computer Science,620229,399352,82853,98641,48033,1249108
2020,Civil,850470,289427,128022,85794,65088,1418801
2022,Mechanical,758069,347180,82736,74231,73465,1335681
2022,Civil,621101,353550,113724,51011,47527,1186913
2019,Civil,640391,388039,91440,73427,41964,1235261
2022,Electrical,806935,387733,110284,88392,71005,1464349
2023,Mechanical,672723,327952,91646,65229,49698,1207248
2023,Civil,826293,316046,94342,63244,34406,1334331
2019,Civil,790477,356918,145620,66602,59002,1418619
2020,Electrical,766020,285200,144261,94548,58682,1348711
2020,Electrical,890604,317442,81935,74462,37591,1402034
2022,Computer Science,797190,442743,122376,75302,33119,1470730
2022,Civil,779354,341070,122481,73536,51873,1368314
2022,Computer Science,691725,308168,135721,72210,66279,1274103
2020,Civil,812139,298322,82838,55585,66596,1315480
2021,Computer Science,685779,463056,115330,99130,46949,1410244
2023,Electrical,603060,418768,116994,96873,37651,1273346
2021,Mechanical,725806,320246,110384,67195,56896,1280527
2021,Electrical,875875,490916,125378,64837,61660,1618666
2020,Computer Science,715871,419964,112643,97161,71860,1417499
2021,Computer Science,620719,487213,96926,55456,40370,1300684
2019,Mechanical,649116,265583,118977,87289,74552,1195517
2022,Civil,626325,332720,103652,59775,65539,1188011
2019,Computer Science,614551,436287,143295,64099,36777,1295009
2023,Computer Science,886422,405925,90270,86805,30113,1499535
2022,Computer Science,615141,387181,141630,91842,30531,1266325
2021,Mechanical,895759,489285,116417,96754,39714,1637929
2023,Electrical,722058,309757,126894,66815,33410,1258934
2022,Computer Science,793823,256659,136042,62226,39236,1287986
2021,Mechanical,712684,251238,143253,80072,54608,1241855
2019,Computer Science,889596,371270,128841,59139,38324,1487170
2022,Civil,650391,369211,132723,80060,41159,1273544
2021,Mechanical,720288,265064,100317,94867,64494,1245030
2019,Computer Science,806132,412187,135008,59859,70985,1484171
2023,Mechanical,713535,413024,116434,93942,62107,1399042
2023,Computer Science,742770,386692,126125,52539,65416,1373542
2023,Electrical,839947,349790,80557,93073,61835,1425202
2023,Computer Science,686711,352985,124383,63199,75600,1302878
2020,Mechanical,864509,294258,86040,83158,39453,1367418
2022,Civil,828625,385542,126652,50082,64833,1455734
2022,Civil,643372,403075,140941,91736,57921,1337045
2020,Civil,644134,408643,106110,62281,30933,1252101
2021,Computer Science,899967,274668,85349,65120,61008,1386112
2021,Electrical,671158,327259,110374,59946,31050,1199787
2023,Computer Science,837159,362192,122591,60891,55392,1438225
2019,Civil,733021,346576,80057,69640,62177,1291471
2021,Mechanical,649396,355481,144578,76111,69884,1295450
2019,Civil,631912,361505,99121,88775,52851,1234164
2022,Mechanical,656947,413118,85493,83290,41106,1279954
2019,Electrical,644387,452049,147818,80604,36878,1361736
2022,Mechanical,878652,497600,81431,84462,30792,1572937
2020,Computer Science,709249,458327,140469,68636,41367,1418048
2020,Computer Science,601919,255397,142241,54837,68731,1123125
2023,Computer Science,740689,349925,125294,61801,39547,1317256
2021,Mechanical,633298,333481,91351,73710,64153,1195993
2023,Computer Science,837225,403305,112483,91237,58568,1502818
2022,Computer Science,833725,464408,111195,81621,72331,1563280
2023,Computer Science,876600,310308,102735,99299,54307,1443249
2019,Electrical,709599,450798,95203,90916,34138,1380654
2022,Mechanical,683721,444291,83974,63065,77112,1352163
2020,Mechanical,886384,484430,119713,95474,37693,1623694
2021,Civil,871372,251130,92636,78230,41394,1334762
2022,Mechanical,883830,374293,115070,86388,53876,1513457
2022,Electrical,611920,264071,109123,60631,69095,1114840
2019,Mechanical,607432,335517,111812,79828,33353,1167942
2021,Electrical,710507,360240,108760,59131,76132,1314770
2020,Electrical,824647,252118,84966,64307,45205,1271243
2022,Mechanical,764982,381735,96058,53709,34628,1331112
2022,Civil,721764,312408,121482,98754,59990,1314398
2019,Computer Science,761298,301786,82998,96683,68095,1310860
2023,Computer Science,804222,331271,141265,70721,57623,1405102
2020,Mechanical,712557,269158,146445,82194,77049,1287403
2021,Mechanical,618013,281087,114648,55094,51433,1120275
2022,Electrical,621446,338114,140623,59415,79220,1238818
2022,Mechanical,801447,434193,87527,98846,40058,1462071
2020,Electrical,702261,269874,83072,98244,56524,1209975
2023,Civil,862701,489139,92018,63530,42093,1549481
2022,Mechanical,768461,333443,109652,57472,46684,1315712
2020,Computer Science,778772,290821,84476,86131,58698,1298898
2019,Computer Science,730878,365675,107482,69407,78755,1352197
2023,Mechanical,699143,310582,142513,68201,48984,1269423
2021,Electrical,624578,372603,96219,77948,44907,1216255
2022,Computer Science,674779,403859,110448,96908,42921,1328915
2020,Electrical,740668,445775,105120,99835,50402,1441800
2019,Mechanical,672534,402777,86855,73115,76794,1312075
2021,Mechanical,872273,319381,136553,77961,33082,1439250
2020,Computer Science,797118,361800,148633,97083,37074,1441708
2020,Mechanical,873740,485677,124585,97182,59330,1640514
2021,Civil,665355,380805,81084,52017,47623,1226884
2019,Civil,612974,425725,101944,54223,73328,1268194
2019,Computer Science,797745,332018,113921,84952,30459,1359095
2023,Civil,851366,350592,141282,73075,32801,1449116
2022,Electrical,674442,341626,131397,56531,58831,1262827
2021,Computer Science,752890,336217,98070,54666,46847,1288690
2021,Computer Science,655598,413324,134987,73781,30997,1308687
2021,Electrical,733726,454404,136690,94023,52025,1470868
2019,Civil,633758,322799,141134,85236,62379,1245306
2022,Civil,886348,312185,139439,90059,36384,1464415
2023,Civil,727309,459385,111489,90023,43223,1431429
2020,Computer Science,766000,291538,103178,86688,78067,1325471
2020,Computer Science,784681,270343,137956,54236,41198,1288414
2021,Civil,630552,486761,127802,51939,64446,1361500
2022,Mechanical,747278,461470,142778,86624,63632,1501782
2019,Civil,634831,422304,137719,82818,39382,1317054
2022,Electrical,643563,370026,113573,65926,54120,1247208
2022,Computer Science,618361,484257,113688,77552,65465,1359323
2019,Electrical,674469,303106,126475,80100,56950,1241100
2021,Electrical,625816,364322,130697,51360,74875,1247070
2022,Computer Science,857422,331227,113978,89573,59968,1452168
2020,Mechanical,746691,434151,109677,94696,32926,1418141
2019,Civil,834295,406100,90272,61994,45735,1438396
2023,Electrical,692479,292135,86212,74941,44223,1189990
2021,Computer Science,626819,412138,101071,77531,70310,1287869
2019,Electrical,608798,369599,97297,85813,67197,1228704
2023,Civil,756215,479789,131932,61093,45362,1474391
2023,Mechanical,843942,333470,136884,83025,76699,1474020
2022,Mechanical,830259,270910,108625,61651,69986,1341431
2022,Mechanical,729544,494090,108831,82812,53409,1468686
2022,Computer Science,752254,388213,136478,74844,32397,1384186
2019,Computer Science,853800,295950,142909,67718,44451,1404828
2019,Mechanical,609415,436795,109367,99823,35814,1291214
2021,Civil,687638,266225,125813,98122,52888,1230686
2022,Civil,618452,481322,100121,63589,37522,1301006
2023,Computer Science,795457,468195,115547,89768,52169,1521136
2020,Mechanical,710205,282959,143642,70022,50382,1257210
2021,Civil,618170,299192,104914,97248,45588,1165112
2019,Civil,616259,329711,97178,88853,75127,1207128
2021,Civil,884243,391123,147258,50234,45762,1518620
2021,Computer Science,740721,452500,140563,56834,45577,1436195
2021,Mechanical,729394,253449,130050,65055,50931,1228879
2021,Electrical,772109,422167,142607,53207,39970,1430060
2020,Mechanical,873949,354213,145638,52400,69278,1495478
2022,Mechanical,854599,459001,93262,59609,50045,1516516
2023,Computer Science,643147,410262,87453,71473,77773,1290108
2021,Civil,674280,350245,125174,95330,45919,1290948
2021,Civil,777125,347069,86172,73935,74329,1358630
2021,Computer Science,697841,407213,97918,73874,57671,1334517
2022,Computer Science,724726,483597,87197,90508,40349,1426377
2019,Computer Science,676215,273908,93677,75015,79203,1198018
2019,Computer Science,712909,354847,91039,64184,36058,1259037
2020,Computer Science,873129,370910,107785,96806,74321,1522951
2019,Electrical,874535,413394,84570,79543,33515,1485557
2021,Mechanical,604861,431782,91655,50650,33330,1212278
2021,Mechanical,861968,264012,127907,82389,64442,1400718
2021,Mechanical,783000,415961,89449,99185,73825,1461420
2020,Civil,896508,267412,104630,77328,47745,1393623
2021,Electrical,849072,477222,126371,69416,38978,1561059
2019,Mechanical,824402,360030,90991,63119,46939,1385481
2022,Civil,642923,274657,104887,57644,45264,1125375
2022,Electrical,786968,255656,93859,58653,56615,1251751
2023,Electrical,765912,390039,103640,64416,62165,1386172
2019,Civil,773327,466030,128339,74897,77362,1519955
2021,Electrical,728165,396836,133235,51874,72722,1382832
2022,Civil,830314,265873,82512,60429,64880,1304008
2019,Mechanical,895673,344485,101912,62213,48594,1452877
2022,Civil,744013,359383,115515,98987,45523,1363421
2021,Electrical,601669,432102,95416,67640,31701,1228528
2022,Mechanical,816854,448879,123746,86008,62758,1538245
2023,Mechanical,655786,251607,123775,65802,65480,1162450
2023,Computer Science,782155,400595,92227,66122,56983,1398082
2022,Computer Science,620323,298447,93031,71653,65084,1148538
2019,Electrical,830502,299757,113000,93671,77427,1414357
2019,Civil,857249,474598,131253,74101,69237,1606438
2019,Civil,606021,319201,147564,51409,64378,1188573
2022,Electrical,713415,378765,98313,93388,50736,1334617
2019,Mechanical,870855,462916,137751,84600,36343,1592465
2021,Electrical,607904,452460,132492,68408,45797,1307061
2023,Electrical,664033,255462,110364,55736,72087,1157682
2021,Mechanical,831659,366832,98361,54993,51875,1403720
2019,Civil,720035,412867,147949,93871,71864,1446586
2021,Electrical,820859,450878,111070,97165,71123,1551095
2019,Civil,786168,298465,102409,81247,39328,1307617
2022,Electrical,821666,442181,109854,78821,67478,1520000
2021,Mechanical,831853,340027,109655,53213,32025,1366773
2022,Mechanical,865237,300528,89952,93123,30105,1378945
2022,Computer Science,887062,286230,116365,79495,59370,1428522
2020,Mechanical,793708,298242,146156,56208,50843,1345157
2019,Computer Science,789878,446955,136724,59644,49476,1482677
2023,Electrical,740466,364688,95455,56453,72981,1330043
2019,Civil,724501,479438,127673,61093,72112,1464817
2023,Mechanical,860228,251783,80974,96509,78610,1368104
2019,Mechanical,692510,278390,92679,61263,30698,1155540
2022,Mechanical,693708,389489,141791,50305,58443,1333736
2021,Electrical,697819,322102,107429,84152,74230,1285732
2021,Computer Science,835603,267426,98073,82021,71706,1354829
2020,Electrical,636303,280750,110365,67958,68839,1164215
2023,Civil,627453,308188,135928,50872,52123,1174564
2023,Electrical,799521,260872,87784,91128,71920,1311225
2023,Civil,756837,344231,92291,71962,49875,1315196
2022,Mechanical,822787,379860,106154,92563,33297,1434661
2023,Civil,638057,429158,105650,67414,30208,1270487
2021,Civil,789060,316770,148741,59926,49700,1364197
2022,Computer Science,694655,481360,116201,98259,51791,1442266
2019,Civil,877169,475440,119479,89673,37233,1598994
2023,Civil,869289,374158,130243,87210,31891,1492791
2023,Electrical,701206,333514,148595,65290,77594,1326199
2019,Mechanical,786869,469249,111734,53667,66274,1487793
2023,Electrical,673230,342663,122568,67660,32039,1238160
2019,Electrical,755002,415792,105793,56553,49673,1382813
2022,Mechanical,708138,399151,132204,66926,72412,1378831
2021,Mechanical,807097,398410,126746,54808,69413,1456474
2019,Civil,812376,384363,111989,78612,58436,1445776
2020,Civil,662040,455156,129465,90499,64385,1401545
2019,Computer Science,708668,362808,141383,78015,38186,1329060
2023,Electrical,798768,360091,96767,83351,30434,1369411
2022,Mechanical,656815,349272,118652,99662,40519,1264920
2022,Civil,816741,299393,93383,59138,48030,1316685
2019,Mechanical,712789,343558,140089,90463,41355,1328254
2021,Civil,819478,319770,106440,86241,44328,1376257
2020,Computer Science,767644,276720,132443,51198,35258,1263263
2022,Computer Science,785102,487714,136325,77447,75722,1562310
2023,Mechanical,844533,486725,135919,86763,37190,1591130
2023,Computer Science,837469,263368,96611,62113,52479,1312040
2021,Mechanical,833308,435385,143483,78749,50827,1541752
2022,Civil,760275,297969,102457,87303,78364,1326368
2019,Electrical,677088,298838,90256,88639,75238,1230059
2023,Computer Science,605608,258734,134856,69687,40747,1109632
2021,Civil,645667,357187,120533,52447,60917,1236751
2022,Electrical,655547,349329,108281,59408,60377,1232942
2022,Electrical,834907,393269,147275,89612,74956,1540019
2022,Electrical,657560,318895,81525,67674,70481,1196135
2022,Civil,814601,484633,96453,62413,63148,1521248
2022,Civil,759487,370424,86251,97937,71784,1385883
2023,Mechanical,784286,437903,99507,57549,53557,1432802
2021,Electrical,880141,351255,107906,73071,74335,1486708
2022,Electrical,721266,308073,93193,58693,64405,1245630
2020,Electrical,603679,453997,144042,93831,42479,1338028
2020,Mechanical,640308,494042,139516,66770,53927,1394563
2021,Electrical,806096,461560,110692,91371,63292,1533011
2019,Civil,770914,475683,113512,52006,49491,1461606
2019,Electrical,605695,465547,90719,55213,31093,1248267
2019,Computer Science,826812,493603,135427,86636,61008,1603486
2020,Civil,658499,431374,107649,59530,30104,1287156
2019,Mechanical,623382,265624,92402,97128,48123,1126659
2023,Electrical,876379,448343,89216,56637,56936,1527511
2022,Computer Science,793295,274315,111050,99504,48060,1326224
2020,Mechanical,733438,267422,130093,54964,54288,1240205
2021,Mechanical,758539,420209,85050,84070,73314,1421182
2021,Civil,606764,322663,126716,57749,54411,1168303
2022,Mechanical,821968,351216,82438,50846,67684,1374152
2020,Mechanical,713831,429304,127431,63390,75091,1409047
2019,Mechanical,661836,459214,96760,63735,43336,1324881
2019,Mechanical,894067,282743,96473,73905,67924,1415112
2023,Electrical,855033,480618,123815,64876,41626,1565968
2023,Electrical,616292,396708,142460,63967,33501,1252928
2019,Electrical,883083,471956,89257,68262,46850,1559408
2021,Electrical,843772,260108,105634,86873,65712,1362099
2021,Computer Science,618800,454706,140403,70014,50678,1334601
2023,Electrical,656440,286180,126573,74054,45905,1189152
2022,Mechanical,727521,268883,108648,79955,31591,1216598
2019,Electrical,721327,294400,128980,73051,43522,1261280
2023,Electrical,649648,427071,90296,78385,46153,1291553
2023,Civil,891908,297951,140197,85587,66840,1482483
2019,Mechanical,894614,388232,101959,77483,33572,1495860
2019,Electrical,856160,305262,94570,77653,68746,1402391
2021,Electrical,769573,401001,115423,90845,63061,1439903
2022,Electrical,657207,333133,97899,94790,55497,1238526
2022,Computer Science,662157,392195,115785,92018,52242,1314397
2019,Electrical,734288,365106,142806,80894,31338,1354432
2020,Civil,753144,409429,136963,79842,46151,1425529
2023,Mechanical,693778,320496,114341,69648,56990,1255253
2023,Mechanical,730016,414628,85597,81756,45380,1357377
2019,Electrical,724288,464863,90244,72407,61035,1412837
2020,Electrical,768204,311934,83796,94561,75813,1334308
2021,Electrical,710573,328886,108528,67058,56117,1271162
2019,Mechanical,720730,280881,98648,60070,32498,1192827
2019,Mechanical,664186,268409,80535,89025,77881,1180036
2023,Computer Science,867104,436488,128469,83779,55483,1571323
2019,Civil,618781,348171,144912,66616,35728,1214208
2019,Computer Science,837677,449054,124493,80373,48877,1540474
2019,Civil,857506,411729,125785,84941,56703,1536664
2023,Computer Science,631126,467815,146561,86152,33088,1364742
2021,Mechanical,838217,298951,110869,50797,69049,1367883
2021,Computer Science,880027,258752,145094,89889,53179,1426941
2019,Civil,629782,367339,110192,63594,77954,1248861
2023,Electrical,748051,394512,149157,97754,52011,1441485
2021,Civil,895890,294864,137544,57690,42839,1428827
2021,Electrical,861161,430763,84403,62669,53625,1492621
2021,Mechanical,666266,322035,116091,68973,48481,1221846
2023,Civil,600056,336675,132510,71085,61753,1202079
2023,Computer Science,893601,461375,85017,78787,49558,1568338
2019,Civil,732773,272343,119203,75084,46771,1246174
2022,Electrical,787453,474320,136473,74051,61104,1533401
2021,Mechanical,781510,269673,132123,61554,63066,1307926
2022,Computer Science,680636,441026,128260,87639,74420,1411981
2023,Civil,666483,435770,125938,63354,34061,1325606
2023,Electrical,620505,345024,137929,55289,63241,1221988
2023,Computer Science,633525,276520,117372,74744,46161,1148322
2022,Mechanical,811474,490713,133252,67945,35057,1538441
2023,Computer Science,696008,495195,94628,74243,75847,1435921
2019,Mechanical,644348,265784,92501,98599,74173,1175405
2023,Computer Science,802259,367446,110131,89054,78936,1447826
2020,Civil,869417,288079,148348,74227,35289,1415360
2022,Electrical,806641,294220,89402,77748,71408,1339419
2020,Civil,734607,401563,135956,66958,32221,1371305
2023,Civil,814096,362878,131920,96684,72942,1478520
2019,Mechanical,707157,366583,106000,59934,51635,1291309
2021,Mechanical,600908,298720,147462,95530,49026,1191646
2023,Mechanical,852299,481876,146392,60550,37075,1578192
2019,Civil,801225,264718,85988,54024,52378,1258333
2022,Computer Science,708352,416669,136999,81772,65084,1408876
2020,Computer Science,695967,311217,149674,58722,43681,1259261
2020,Civil,635079,479423,133426,52120,77721,1377769
2020,Civil,812628,350668,138824,80089,61584,1443793
2022,Electrical,711889,407904,140659,71348,61245,1393045
2019,Mechanical,862063,435890,117790,55877,34983,1506603
2022,Mechanical,646105,478470,102118,93488,62249,1382430
2020,Civil,732957,393936,132025,68904,61391,1389213
2023,Civil,601049,338378,139938,70792,60897,1211054
2021,Computer Science,653281,258177,85149,76037,70602,1143246
2022,Civil,666697,427187,118079,67335,50002,1329300
2022,Computer Science,636534,372318,82484,64659,40498,1196493
2019,Civil,693034,487307,135474,79684,79411,1474910
2019,Electrical,658097,437282,128601,50964,33206,1308150
2022,Electrical,784885,433026,123809,84902,78588,1505210
2020,Computer Science,887181,361145,100791,85012,72472,1506601
2021,Mechanical,627278,392916,149343,85571,42930,1298038
2019,Electrical,739344,455202,106648,53911,40320,1395425
2020,Computer Science,673277,263418,111090,61216,58014,1167015
2023,Civil,604694,415926,97857,51408,67946,1237831
2019,Civil,658150,469716,142327,71621,61817,1403631
2020,Computer Science,667470,457027,122967,70977,68126,1386567
2020,Mechanical,621556,338075,133709,63195,56752,1213287
2021,Computer Science,795543,490978,147948,93938,34507,1562914
2021,Computer Science,649086,425022,128861,90431,53925,1347325
2023,Electrical,749979,315227,148718,92577,66276,1372777
2020,Computer Science,848399,393907,100948,57113,53689,1454056
2020,Computer Science,779559,267533,113782,90910,75670,1327454
2021,Civil,699468,495822,130756,72761,45238,1444045
2019,Electrical,895531,476123,148388,74992,54807,1649841
2019,Civil,668602,351457,146809,63778,69522,1300168
2022,Civil,602460,357504,87649,71985,38921,1158519
2021,Mechanical,672356,468930,109002,54367,41204,1345859
2022,Mechanical,859925,391295,114723,95447,68284,1529674
2021,Electrical,616191,374202,91809,60786,68567,1211555
2023,Electrical,684631,260273,138169,95780,65697,1244550
2020,Mechanical,845702,283519,88302,92706,76653,1386882
2023,Mechanical,872673,405232,88100,94461,54893,1515359
2021,Mechanical,632175,377024,148447,80908,31530,1270084
2020,Mechanical,879819,455457,135020,61051,61241,1592588
2019,Mechanical,757048,374540,85663,86746,54297,1358294
2019,Civil,794188,496460,124649,65611,39302,1520210
2022,Electrical,662821,472264,127136,54490,78906,1395617
2021,Civil,612204,430060,116104,81313,30715,1270396
2021,Civil,869538,391420,119137,56377,39533,1476005
2019,Computer Science,846464,333460,82534,59903,70295,1392656
2023,Civil,633593,498792,147762,64567,37223,1381937
2020,Mechanical,808260,354471,132445,72885,43421,1411482
2023,Mechanical,715064,354668,89585,78222,57696,1295235
2023,Computer Science,653365,317519,116392,98556,44066,1229898
2019,Computer Science,840644,340426,111126,76606,74047,1442849
2019,Computer Science,820511,264629,122485,67440,51576,1326641
2019,Computer Science,806971,299056,125798,52260,46585,1330670
2022,Computer Science,703700,261273,148310,80267,32140,1225690
2023,Civil,668247,370484,89017,77002,72016,1276766
2021,Computer Science,782631,347275,105700,66833,66439,1368878
2020,Civil,756270,421488,116507,99720,71378,1465363
2022,Electrical,753560,388966,127679,53498,37370,1361073
2021,Computer Science,769587,296073,117232,96729,59516,1339137
2023,Computer Science,890042,295693,104020,60518,42022,1392295
2019,Civil,781142,432538,137172,62501,48328,1461681
2023,Electrical,662613,274343,93746,72254,32929,1135885
2020,Civil,696707,293095,143537,84076,73727,1291142
2022,Civil,647003,412246,84094,65902,33383,1242628
2022,Computer Science,648478,431873,148466,83485,79545,1391847
2020,Mechanical,659030,372388,110755,75545,57432,1275150
2021,Mechanical,784133,490787,91552,53345,41111,1460928
2021,Civil,745921,453508,139491,65370,78338,1482628
2022,Computer Science,846160,364441,99779,96721,69778,1476879
2022,Electrical,867589,450408,109000,78231,61899,1567127
2019,Mechanical,749112,350782,133953,91863,53161,1378871
2021,Electrical,862390,489343,137564,59642,38823,1587762
2020,Mechanical,631153,423998,94102,67839,57432,1274524
2021,Computer Science,867356,322590,81861,73681,63089,1408577
2019,Civil,734411,419899,123574,57035,51053,1385972
2022,Electrical,656238,358263,112682,83299,47447,1257929
2022,Electrical,896751,425847,145185,85035,54305,1607123
2019,Civil,652055,422273,128120,99484,33111,1335043
2020,Electrical,704509,279373,118297,73583,57493,1233255
2022,Mechanical,735467,277525,88299,72105,40985,1214381
2023,Civil,727378,377716,121348,66130,33086,1325658
2022,Mechanical,687687,354513,121384,63736,76203,1303523
2023,Mechanical,702652,453723,112687,92281,74930,1436273
2019,Computer Science,655773,379401,144577,63815,53464,1297030
2019,Mechanical,802668,346643,140047,74396,71918,1435672
2022,Computer Science,627584,411558,90191,74312,66911,1270556
2021,Electrical,844901,459676,136884,62244,36332,1540037
2023,Electrical,865482,399712,134911,92668,69215,1561988
2020,Computer Science,662601,347694,123726,61718,72542,1268281
2022,Mechanical,736559,442527,114623,66784,70631,1431124
2020,Civil,636282,286136,130000,80683,33176,1166277
2022,Civil,826137,443497,143027,94590,32416,1539667
2021,Computer Science,695798,306539,138995,93997,70436,1305765
2021,Electrical,730963,462736,122876,81428,38651,1436654
2021,Electrical,759876,406014,131070,86759,40486,1424205
2021,Civil,740987,318363,146224,76490,48695,1330759
2019,Computer Science,873302,439668,105365,90701,31229,1540265
2019,Civil,805229,331526,109663,97351,31530,1375299
2023,Mechanical,610547,285255,145436,91001,75585,1207824
2020,Mechanical,864603,443201,143211,95856,72347,1619218
2022,Computer Science,663146,466595,90909,66410,65565,1352625
2022,Computer Science,707761,368209,140883,85386,31363,1333602
2019,Mechanical,682970,492723,92713,59362,67270,1395038
2022,Electrical,791889,443358,92614,89407,46836,1464104
2019,Computer Science,769319,336437,100734,74011,50288,1330789
2023,Mechanical,615419,397349,110709,57042,52380,1232899
2020,Mechanical,635577,382715,102885,75286,75869,1272332
2023,Electrical,602921,365900,93341,61391,79729,1203282
2021,Electrical,744535,273729,119435,76999,50303,1265001
2021,Electrical,756546,467695,92976,52018,73972,1443207
2021,Electrical,725534,271818,85290,62952,37317,1182911
2023,Civil,856872,315555,125812,66240,33264,1397743
2022,Electrical,672828,348979,130528,71262,48315,1271912
2020,Civil,723649,303629,138570,69282,67010,1302140
2021,Computer Science,655152,365296,136399,72459,42693,1271999
2021,Mechanical,820073,305438,128437,84815,46566,1385329
2021,Civil,823393,495821,137907,67942,54811,1579874
2020,Computer Science,686569,259457,128723,51722,63405,1189876
2021,Computer Science,756844,440701,115655,86820,49856,1449876
2020,Civil,759562,283922,135833,51651,79676,1310644
2021,Computer Science,722537,390892,103997,71606,57366,1346398
2023,Computer Science,653806,413822,146876,84546,76970,1376020
2023,Civil,675992,358122,106013,50683,65138,1255948
2020,Computer Science,884464,352020,112862,92239,72244,1513829
2023,Electrical,858852,484618,132448,68394,72683,1616995
2020,Electrical,773217,418862,125608,96705,40638,1455030
2023,Mechanical,794760,338405,120894,68966,50816,1373841
2023,Computer Science,620754,366130,130649,76469,50598,1244600
2020,Mechanical,669837,415493,142104,58505,72541,1358480
2022,Electrical,738279,318038,119821,90211,40652,1307001
2023,Electrical,818811,499029,127940,55492,46963,1548235
2021,Electrical,714780,463273,90935,66827,78511,1414326
2022,Computer Science,687081,312325,92467,77492,62223,1231588
2020,Computer Science,886160,275600,91073,53266,61024,1367123
2022,Electrical,712099,410466,87691,55909,33941,1300106
2019,Mechanical,751174,460694,126538,62869,38387,1439662
2019,Mechanical,864068,417243,104490,89782,38524,1514107
2023,Civil,685015,480611,95688,71863,65859,1399036
2023,Electrical,704987,311526,130650,94055,67486,1308704
2021,Mechanical,654333,263149,93829,57819,71617,1140747
2022,Electrical,815530,411466,83086,79136,55279,1444497
2019,Mechanical,777171,395468,82590,64837,56025,1376091
2023,Civil,788418,404396,119893,97954,47636,1458297
2022,Civil,726372,428270,118176,60056,71483,1404357
2023,Electrical,806553,463777,147484,50715,73224,1541753
2023,Mechanical,669767,362168,106295,67275,43277,1248782
2019,Computer Science,704332,494882,118131,70191,78718,1466254
2019,Civil,743279,359813,124893,66884,65190,1360059
2023,Electrical,606336,341779,91924,95462,70995,1206496
2020,Electrical,806238,412088,90851,58894,71735,1439806
2023,Mechanical,879400,384266,87734,68717,79179,1499296
2023,Electrical,830517,282398,122681,68578,37539,1341713
2021,Civil,780889,254789,85293,73321,62853,1257145
2021,Electrical,895863,466767,133203,92969,56811,1645613
2021,Electrical,645704,314967,93820,74959,56928,1186378
2020,Computer Science,892157,490014,147827,60515,36909,1627422
2020,Computer Science,826884,442206,127163,59077,58069,1513399
2023,Civil,767848,451958,92391,71443,76084,1459724
2021,Mechanical,872204,348837,121970,60443,67421,1470875
2020,Computer Science,819182,406049,126823,87208,38033,1477295
2019,Mechanical,678563,351967,110796,51783,40748,1233857
2023,Civil,735102,381201,116389,63113,76693,1372498
2022,Computer Science,689779,309683,83352,55385,35066,1173265
2023,Mechanical,764361,295331,108172,86885,75272,1330021
2022,Computer Science,699704,498719,90937,56982,78664,1425006
2021,Civil,861757,284626,146481,85351,79408,1457623
2022,Civil,710234,429575,103552,92689,41998,1378048
2021,Computer Science,636491,408621,94118,63407,43764,1246401
2019,Mechanical,826621,262342,91290,65316,64215,1309784
2022,Electrical,620448,286417,105123,96524,75379,1183891
2023,Electrical,649294,457586,139551,74838,45858,1367127
2021,Computer Science,883590,433321,132136,77207,68468,1594722
2023,Mechanical,816461,302664,143886,98116,66111,1427238
2020,Electrical,685615,484236,147333,78402,47077,1442663
2021,Civil,617101,488788,124016,52430,40257,1322592
2022,Mechanical,890160,258833,101427,89828,77210,1417458
2021,Electrical,750004,310658,82257,52936,74560,1270415
2023,Mechanical,690481,493511,147733,61864,75180,1468769
2019,Computer Science,652802,480099,88222,75115,33665,1329903
2021,Mechanical,869693,410545,105187,59307,65442,1510174
2022,Electrical,810005,381809,100781,56709,73358,1422662
2020,Computer Science,756434,344965,91004,79854,46734,1318991
2019,Mechanical,647842,427719,137600,91843,38840,1343844
2020,Civil,646539,314054,105515,70707,42062,1178877
2021,Electrical,633717,251299,83185,89384,37044,1094629
2023,Computer Science,846281,444353,134476,85187,32063,1542360
2023,Mechanical,786272,499240,111212,51399,52313,1500436
2022,Civil,715042,315875,128533,92536,57087,1309073
2023,Electrical,727922,413992,117630,74188,75779,1409511
2019,Civil,692447,435908,148606,64245,70181,1411387
2023,Mechanical,758693,423453,96585,95746,48205,1422682
2022,Mechanical,612823,493131,129240,73371,42464,1351029
2021,Computer Science,629986,364286,94772,97204,73550,1259798
2021,Civil,721682,466043,97938,82286,57132,1425081
2023,Computer Science,664325,348730,101983,71693,72638,1259369
2020,Electrical,850476,306298,92874,84303,67427,1401378
2021,Computer Science,657771,405581,140896,71137,65048,1340433
2023,Electrical,654973,371035,126209,91049,33749,1277015
2022,Mechanical,745762,423167,112822,65365,65306,1412422
2023,Mechanical,657888,432596,100750,63450,55592,1310276
2021,Civil,610956,359825,122083,54190,79595,1226649
2022,Electrical,686839,365637,107946,92861,48451,1301734
2023,Mechanical,767605,447981,81552,93639,58258,1449035
2019,Civil,701131,322618,85271,73937,74758,1257715
2022,Civil,787973,275532,145651,57452,65302,1331910
2019,Computer Science,611519,358197,108994,53960,62856,1195526
2020,Civil,762187,380860,107186,89602,51621,1391456
2022,Mechanical,601832,310285,110267,80185,36577,1139146
2019,Computer Science,713922,268866,119140,60564,49694,1212186
2021,Electrical,705474,388665,104935,97510,38263,1334847
2021,Electrical,669715,259495,111748,55091,47205,1143254
2020,Mechanical,673366,496130,83837,99670,38072,1391075
2022,Mechanical,637570,257837,144875,80519,79967,1200768
2022,Computer Science,737687,457780,142694,53710,75306,1467177
2022,Computer Science,638311,399752,89610,99981,73876,1301530
2020,Mechanical,703187,436548,108615,89395,70130,1407875
2022,Mechanical,885578,280346,102347,57988,73002,1399261
2021,Electrical,686879,358621,114062,85754,35691,1281007
2019,Electrical,615739,273412,135122,78114,52113,1154500
2021,Electrical,666202,469471,128431,73074,31953,1369131
2021,Mechanical,698580,368833,108205,71198,34963,1281779
2019,Civil,824491,411876,98459,60509,68754,1464089
2021,Mechanical,679599,315206,103750,75180,70520,1244255
2020,Mechanical,764721,260934,107729,98068,57869,1289321
2019,Electrical,831436,280723,118585,95433,41445,1367622
2021,Mechanical,716770,377968,125635,66560,67759,1354692
2023,Computer Science,779693,401477,124854,93281,50185,1449490
2021,Mechanical,861051,399820,109104,92674,38447,1501096
2020,Mechanical,714300,451838,94770,88938,64699,1414545
2022,Mechanical,791012,427485,97957,85391,63640,1465485
2021,Mechanical,771796,403426,135178,78731,37954,1427085
2022,Civil,762776,455562,100828,69162,47945,1436273
2023,Mechanical,841942,371988,97171,98344,68294,1477739
2021,Computer Science,602526,469747,141465,75236,42920,1331894
2019,Computer Science,868718,491630,93146,87133,59984,1600611
2022,Mechanical,870877,398460,126266,61379,35560,1492542
2023,Electrical,636051,486433,125939,54340,45389,1348152
2019,Civil,615909,286523,94202,54755,54265,1105654
2019,Mechanical,677338,351150,117142,98731,71853,1316214
2019,Mechanical,890277,370950,143828,91866,37715,1534636
2019,Mechanical,782643,438765,139046,98759,49068,1508281
2021,Electrical,679062,416804,89849,69905,39438,1295058
2021,Electrical,781980,291646,139272,68259,79898,1361055
2021,Electrical,651458,402093,100439,81255,35243,1270488
2023,Civil,822159,474310,115344,86726,58629,1557168
2023,Computer Science,887442,492024,133276,84904,69594,1667240
2023,Civil,831946,482131,85051,93556,34085,1526769
2020,Electrical,753263,302776,129474,91813,68885,1346211
2023,Computer Science,764164,269116,96967,81614,47390,1259251
2021,Computer Science,689407,453081,101773,50506,54513,1349280
2021,Electrical,806329,362858,121182,58599,50694,1399662
2020,Electrical,662513,469343,143589,71774,71850,1419069
2020,Civil,745476,481069,104180,58715,73451,1462891
2023,Electrical,635198,326620,144372,71997,44884,1223071
2022,Computer Science,825295,425843,131372,85818,32876,1501204
2020,Mechanical,864323,409828,149086,64783,56207,1544227
2019,Electrical,602019,332604,102163,81262,35556,1153604
2021,Electrical,681455,344452,143089,73476,50491,1292963
2019,Civil,816311,383991,112934,52397,68009,1433642
2021,Civil,749776,273550,135595,90680,78674,1328275
2021,Electrical,749102,417596,106592,77475,77682,1428447
2020,Computer Science,603420,435678,103039,84077,62225,1288439
2020,Computer Science,778725,449891,144099,89970,68437,1531122
2019,Mechanical,616740,320227,114018,57700,35399,1144084
2021,Electrical,705789,273212,133158,54718,71701,1238578
2019,Civil,619465,290118,84558,77111,43648,1114900
2022,Computer Science,604131,278602,112174,88718,60887,1144512
2019,Mechanical,610652,267540,122631,60233,72936,1133992
2023,Electrical,818115,416901,147687,64171,70263,1517137
2019,Computer Science,845289,437381,95552,60726,78373,1517321
2023,Electrical,689342,446475,115065,76768,51804,1379454
2023,Electrical,881315,321455,82614,67139,60919,1413442
2023,Computer Science,817201,272277,114647,50145,76972,1331242
2022,Computer Science,859820,369133,137940,94782,58147,1519822
2019,Computer Science,786764,440745,80620,69958,49295,1427382
2019,Electrical,658541,398748,103082,76203,36897,1273471
2022,Electrical,609470,423916,101891,71307,41276,1247860
2021,Mechanical,792416,445780,142395,84626,68253,1533470
2020,Civil,644308,259752,130955,87490,35838,1158343
2019,Electrical,735669,462620,112314,53598,47157,1411358
2020,Civil,702840,455783,103500,63583,32144,1357850
2022,Computer Science,761860,421742,133685,97637,44406,1459330
2021,Electrical,649477,448675,144783,67013,71952,1381900
2021,Mechanical,708261,412550,130189,97984,56414,1405398
2021,Mechanical,702466,407511,99567,94126,68748,1372418
2022,Civil,895215,415819,105978,86286,77460,1580758
2023,Computer Science,670560,497496,89630,87120,59483,1404289
2023,Civil,855392,375332,92003,94874,77647,1495248
2020,Computer Science,861278,410882,121444,90197,41513,1525314
2023,Mechanical,766471,268302,111607,59096,74802,1280278
2023,Civil,844413,316236,104821,55555,56451,1377476
2021,Mechanical,788511,314467,94601,82719,70909,1351207
2021,Mechanical,602369,352350,125904,57997,78091,1216711
2020,Computer Science,828629,415913,118557,60809,70963,1494871
2019,Civil,862672,425785,132523,77365,52672,1551017
2020,Civil,708806,430618,130502,99259,71124,1440309
2020,Mechanical,761386,253048,102098,75618,42631,1234781
2022,Mechanical,702979,499212,125902,75964,64665,1468722
2022,Computer Science,881892,414362,119253,59868,62291,1537666
2020,Electrical,635109,308906,124280,71882,51817,1191994
2020,Electrical,613919,326637,88951,70639,41432,1141578
2020,Mechanical,811864,279778,88117,86963,48951,1315673
2023,Electrical,670441,408497,105979,91224,38130,1314271
2022,Electrical,666896,488117,96915,86589,74467,1412984
2020,Electrical,703431,464460,139261,99828,53136,1460116
2021,Electrical,647020,370918,115677,79470,32559,1245644
2021,Mechanical,805338,340036,129830,94446,44744,1414394
2023,Electrical,884305,439248,132536,55178,61155,1572422
2023,Electrical,627738,393746,88922,60898,72298,1243602
2019,Computer Science,734997,443474,147561,55566,51021,1432619
2019,Mechanical,657153,469803,93220,70353,46996,1337525
2019,Civil,814020,497181,125958,88188,43187,1568534
2023,Civil,661009,470979,133380,83375,65902,1414645
2023,Computer Science,772624,414125,82766,55674,48006,1373195
2023,Computer Science,871941,498505,113159,72272,46375,1602252
2021,Mechanical,671942,261957,90935,71716,60158,1156708
2023,Civil,718065,322644,83784,73740,77678,1275911
2021,Electrical,876109,434688,100221,73170,33069,1517257
2019,Computer Science,875877,363294,109179,85162,36486,1469998
2019,Civil,757998,267829,98069,61051,47639,1232586
2019,Mechanical,759855,255837,115682,58070,65428,1254872
2020,Electrical,683360,445213,136268,79472,58800,1403113
2020,Mechanical,767466,396104,100110,92807,55618,1412105
2022,Computer Science,795868,349770,111232,84789,67220,1408879
2022,Civil,890431,276352,124273,70982,41869,1403907
2022,Civil,682104,280215,135210,81518,34176,1213223
2020,Civil,761508,437391,109461,69399,66454,1444213
2020,Civil,821404,455714,84610,77313,56480,1495521
2022,Electrical,865332,291247,136973,66110,61500,1421162
2022,Electrical,691205,475374,87583,84816,35237,1374215
2023,Mechanical,832321,379692,105583,72353,56453,1446402
2022,Electrical,737837,424120,97701,78530,30790,1368978
2023,Computer Science,819779,485308,86880,50893,77595,1520455
2021,Computer Science,741879,456604,131845,95811,76954,1503093
2020,Civil,610204,316714,83722,78724,71184,1160548
2022,Computer Science,823674,285319,100077,76885,44754,1330709
2020,Mechanical,789016,369058,93229,94560,43067,1388930
2020,Electrical,702903,266025,141679,63613,46609,1220829
2020,Electrical,899225,259780,91439,64316,57981,1372741
2021,Electrical,856687,272706,115902,56087,49563,1350945
2019,Computer Science,634986,423988,82598,85701,39003,1266276
2022,Electrical,650304,325503,84052,68665,57068,1185592
2019,Civil,639986,411928,92741,91032,76996,1312683
2019,Civil,691594,353166,149360,84148,34223,1312491
2019,Civil,666151,259179,116288,79622,53904,1175144
2020,Computer Science,890358,419695,81249,80298,66834,1538434
2023,Electrical,773620,398659,102970,66867,50746,1392862
2020,Computer Science,741753,404805,95565,91989,61404,1395516
2020,Electrical,738056,469378,136995,94741,51407,1490577
2019,Mechanical,758651,349423,131656,63164,50693,1353587
2020,Mechanical,834347,373076,142134,70163,63014,1482734
2019,Computer Science,786005,385047,125765,56101,52121,1405039
2023,Civil,762553,459527,82014,87722,56403,1448219
2022,Computer Science,600944,325138,94012,88721,41637,1150452
2019,Civil,693993,426535,137498,89048,38612,1385686
2023,Electrical,871258,480668,148776,83546,60410,1644658
2022,Civil,814738,423226,141711,53475,35160,1468310
2021,Civil,808920,456748,122530,54723,64139,1507060
2019,Electrical,856805,499415,98018,64890,37728,1556856
2019,Mechanical,894740,336706,97916,73270,34238,1436870
2021,Electrical,704087,366905,120376,56713,56764,1304845
2021,Computer Science,869051,278830,145046,77853,48464,1419244
2019,Computer Science,855035,360076,138742,58601,61943,1474397
2021,Computer Science,759186,453198,92437,67443,60838,1433102
2020,Computer Science,887153,427817,142146,67984,35919,1561019
2022,Computer Science,766797,280609,107618,62735,67092,1284851
2022,Mechanical,881140,267401,130767,68617,37797,1385722
2022,Mechanical,890911,408801,89705,76228,52467,1518112
2020,Civil,878491,353480,137146,92257,53736,1515110
2021,Computer Science,702063,368278,131750,63974,39021,1305086
2023,Electrical,624102,426239,124379,99503,33058,1307281
2021,Computer Science,604263,475253,132682,96492,39041,1347731
2019,Mechanical,667438,307391,144713,94182,68102,1281826
2022,Computer Science,696359,376543,136919,60623,31153,1301597
2021,Mechanical,730251,378886,140384,65395,67708,1382624
2023,Civil,771915,344583,131128,56469,77375,1381470
2019,Civil,627690,439243,81835,75040,42021,1265829
2020,Civil,602994,469168,101283,93473,57258,1324176
2020,Mechanical,703533,387719,129506,53166,65847,1339771
2023,Computer Science,667546,402178,133625,71637,79554,1354540
2019,Computer Science,626467,256015,115963,52209,49359,1100013
2022,Electrical,846590,271506,89179,58747,56178,1322200
2021,Mechanical,731120,495221,91955,83067,42914,1444277
2019,Electrical,768050,274067,87198,70250,37536,1237101
2020,Civil,673414,380819,147156,74931,63748,1340068
2023,Computer Science,780294,497849,124588,96319,69448,1568498
2023,Mechanical,648115,252056,91766,83331,76132,1151400
2021,Electrical,640647,478327,133570,62201,40486,1355231
2023,Electrical,654607,279328,149874,91982,32384,1208175
2023,Electrical,621996,327712,128679,81305,74312,1234004
2019,Computer Science,683697,302832,85301,67574,75088,1214492
2022,Computer Science,667764,292771,95144,80859,71758,1208296
2021,Computer Science,839190,347421,93784,60096,40787,1381278
2019,Mechanical,608888,467877,147959,60228,64134,1349086
2022,Computer Science,819738,427587,88272,59218,65706,1460521
2019,Mechanical,821432,314538,81573,74831,47646,1340020
2019,Electrical,879477,449722,104419,68802,36187,1538607
2023,Electrical,636355,460050,128555,97381,38495,1360836
2022,Civil,830487,290151,85176,68947,39885,1314646
2021,Computer Science,729686,382701,116161,69335,48700,1346583
2021,Electrical,762217,333463,143440,96861,45018,1380999
2022,Computer Science,849602,346853,138862,79907,60428,1475652
2023,Mechanical,849434,339432,95164,66653,59071,1409754
2020,Electrical,780926,278155,105379,89387,61322,1315169
2019,Computer Science,667664,399360,98368,72031,37114,1274537
2023,Electrical,686153,300588,112771,59119,36574,1195205
2022,Electrical,693616,468023,144950,54555,54996,1416140
2019,Computer Science,897429,417157,120245,96095,56754,1587680
2021,Electrical,856349,261251,123327,51042,68297,1360266
2020,Electrical,646996,352420,126454,88212,33809,1247891
2021,Electrical,728344,406646,126741,54188,76304,1392223
2022,Electrical,829685,259623,111977,63060,47550,1311895
2019,Mechanical,728019,467544,86714,60233,59249,1401759
2022,Electrical,735024,304715,94891,53088,71499,1259217
2019,Civil,783273,256123,132299,51646,68099,1291440
2023,Electrical,720454,253061,145167,63127,51413,1233222
2020,Computer Science,724444,356393,145124,82615,34687,1343263
2023,Civil,753868,352035,138639,50487,68125,1363154
2023,Mechanical,762818,289095,120912,65453,51123,1289401
2022,Civil,600015,440690,148446,84515,63095,1336761
2020,Civil,757029,409523,141516,66911,57435,1432414
2019,Civil,681541,331897,124250,67551,51622,1256861
2019,Computer Science,621292,331443,116116,66278,40285,1175414
2021,Computer Science,762948,368005,102151,70856,73091,1377051
2019,Computer Science,791799,284814,124297,61931,54927,1317768
2022,Mechanical,647046,498904,120888,72188,35291,1374317
2023,Computer Science,614817,335141,136195,50483,71193,1207829
2023,Computer Science,609759,478864,134334,50451,78308,1351716
2023,Civil,779504,457940,148345,54069,33122,1472980
2020,Computer Science,868556,418904,119761,63386,34876,1505483
2019,Electrical,882648,476084,106930,57207,49112,1571981
2022,Computer Science,870651,390517,139117,87165,76474,1563924
2020,Mechanical,621050,414562,103095,88439,39124,1266270
2021,Mechanical,700153,279767,83991,68157,31823,1163891
2022,Electrical,875731,296057,103519,72006,66841,1414154
2022,Mechanical,831329,461818,106657,59190,40387,1499381
2022,Mechanical,657732,470767,80826,90180,67163,1366668
2023,Civil,651921,454172,122625,68449,68819,1365986
2022,Electrical,717734,422115,97801,91357,64244,1393251
2019,Civil,737912,336755,109846,79678,48980,1313171
2022,Civil,631440,277946,119566,64929,54224,1148105
2023,Computer Science,635183,417659,103157,89100,37121,1282220
2022,Electrical,733461,253364,108363,98747,32430,1226365
2021,Computer Science,714515,450926,130559,57913,37954,1391867
2021,Computer Science,820533,437160,85136,59995,41881,1444705
2023,Civil,715503,498540,137937,76727,46917,1475624
2019,Mechanical,639023,327015,97421,51946,47640,1163045
2019,Electrical,781101,388470,87546,86183,42085,1385385
2020,Mechanical,818031,383524,126623,51394,56259,1435831
2023,Civil,676054,337208,96406,97852,53097,1260617
2022,Civil,661742,373208,89825,52421,32978,1210174
2023,Civil,645215,414265,114173,70303,34332,1278288
2020,Civil,759245,460473,135619,90113,50037,1495487
2023,Civil,841443,275345,87923,69467,65781,1339959
2023,Civil,703591,492883,114374,90798,45089,1446735
2020,Mechanical,849045,335895,141713,74504,53484,1454641
2019,Computer Science,646229,455407,121411,60980,44008,1328035
2022,Mechanical,662583,440268,144368,51844,48148,1347211
2020,Electrical,855931,404125,88316,84572,33830,1466774
2021,Mechanical,759996,481500,90556,91849,32958,1456859
2019,Civil,726011,379022,90058,68887,55998,1319976
2021,Mechanical,892248,464292,105482,68277,31540,1561839
2019,Computer Science,840660,386087,124494,87112,60677,1499030
2022,Electrical,899738,478273,105005,72975,59101,1615092
2022,Mechanical,865808,389729,112481,69449,71482,1508949
2023,Computer Science,872672,301116,108401,94601,73967,1450757
2021,Mechanical,759262,403023,120431,69459,37053,1389228
2019,Electrical,797105,347599,144459,51259,35670,1376092
2022,Mechanical,804249,479351,128504,68604,73458,1554166
2020,Civil,728404,276521,83223,63859,77030,1229037
2022,Mechanical,801664,304431,120149,93798,78115,1398157
2020,Computer Science,895043,260731,92863,75362,40281,1364280
2019,Mechanical,617241,399816,109564,77943,48122,1252686
2022,Computer Science,663472,313094,102499,71319,32533,1182917
2022,Electrical,805320,268423,112132,85215,40756,1311846
2019,Mechanical,631346,364612,84533,85897,55074,1221462
2022,Electrical,681196,398640,114409,57697,48802,1300744
2020,Electrical,808196,428483,102987,73075,67844,1480585
2022,Mechanical,749014,253934,90633,81360,57322,1232263
2021,Computer Science,898517,326945,136207,78160,79636,1519465
2023,Electrical,720623,380443,130535,78735,47048,1357384
2020,Electrical,602016,346946,83996,81293,79779,1194030
2021,Mechanical,607274,346344,80014,53949,39876,1127457
2019,Mechanical,615748,389244,81674,60659,67055,1214380
2020,Mechanical,611826,277358,117867,58010,76824,1141885
2023,Mechanical,729288,447385,137251,76769,45171,1435864
2023,Mechanical,801081,379774,135709,73823,72204,1462591
2019,Civil,851054,269763,97864,66400,35166,1320247
2019,Mechanical,772507,429745,106321,90727,40366,1439666
2020,Computer Science,806089,481794,104082,89009,50258,1531232
2022,Electrical,823023,477778,120131,64787,73734,1559453
2019,Computer Science,792949,335997,84210,57906,42983,1314045
2022,Computer Science,669072,491830,144586,95953,55715,1457156
2021,Civil,667309,317975,114851,63303,61085,1224523
2023,Mechanical,760966,388876,106865,51266,75078,1383051
2022,Electrical,785639,492399,84158,83246,57778,1503220
2023,Computer Science,635326,428666,137852,53977,41390,1297211
2022,Mechanical,786131,459820,129339,56068,50924,1482282
2021,Mechanical,867223,337189,100572,94504,75832,1475320
2019,Civil,687340,337507,84100,81227,73004,1263178
2021,Civil,767364,317525,124469,62740,70244,1342342
2019,Civil,718192,454476,140861,72797,30707,1417033
2019,Electrical,851749,488634,98456,57791,71392,1568022
2023,Computer Science,651818,349248,135803,50485,55048,1242402
2021,Civil,613429,274604,145633,95048,79093,1207807
2022,Civil,657748,366585,116232,80695,62815,1284075
2021,Civil,648807,403207,147323,87441,64682,1351460
2023,Computer Science,869284,477152,101788,50337,47489,1546050
2019,Computer Science,838161,418990,96092,75436,78158,1506837
2023,Civil,890669,379716,81132,65092,46951,1463560
2020,Civil,882635,431921,93068,84771,71439,1563834
2020,Mechanical,799888,411919,127401,51471,41452,1432131
2022,Civil,766052,424846,128526,94388,58635,1472447
2023,Electrical,826597,441781,138958,77696,62747,1547779
2022,Electrical,608078,260680,135041,56489,63796,1124084
2022,Civil,691654,363508,143372,57856,57933,1314323
2020,Computer Science,729101,345619,147562,78611,64581,1365474
2022,Mechanical,616997,305037,144046,59365,68281,1193726
2020,Computer Science,731940,349969,148086,84373,51187,1365555
2019,Civil,812650,361115,87089,55664,52953,1369471
2023,Electrical,883390,308914,96623,73323,63818,1426068
2022,Mechanical,751633,407381,129641,76455,54702,1419812
2020,Computer Science,634512,357255,92043,55379,36278,1175467
2021,Computer Science,825226,260349,146572,94353,74566,1401066
2022,Civil,808467,456151,144136,52124,48036,1508914
2019,Mechanical,672144,441892,137061,96189,77495,1424781
2019,Electrical,773557,456068,86122,81536,54583,1451866
2021,Civil,717363,415625,127346,54991,34708,1350033
2020,Mechanical,801484,278525,96150,56794,39476,1272429
2022,Computer Science,781675,255948,92054,79218,35318,1244213
2020,Civil,752110,264498,81767,81113,59269,1238757
2019,Computer Science,693542,400063,84708,86074,68627,1333014
2020,Computer Science,876469,471582,137999,77977,75441,1639468
2019,Civil,766964,482006,132158,78359,54754,1514241
2020,Civil,749068,309790,109292,99302,69361,1336813
2021,Civil,805355,388732,108082,98673,49979,1450821
2023,Civil,716737,276245,114024,68043,34910,1209959
2021,Civil,862968,381310,103461,72523,66022,1486284
2021,Computer Science,840417,400992,85351,59070,34453,1420283
2023,Electrical,717718,296659,127031,57199,51181,1249788
2023,Electrical,873661,499621,119718,68703,53365,1615068
2022,Civil,752755,375983,92777,69267,56326,1347108
2022,Computer Science,807791,324874,88308,64133,70705,1355811
2021,Electrical,849120,292517,123441,78571,34177,1377826
2021,Electrical,854322,376618,93882,76991,33429,1435242
2019,Electrical,809485,325885,84714,61579,62952,1344615
2019,Computer Science,872126,296350,123432,99741,65901,1457550
2022,Civil,745711,327179,97658,83355,34978,1288881
2022,Civil,670210,409346,149245,69003,71466,1369270
2019,Civil,669852,295013,130808,71871,43773,1211317
2019,Mechanical,855139,487275,119530,56223,36174,1554341
2020,Mechanical,609695,289913,88834,64197,51796,1104435
2020,Mechanical,648582,485237,94358,59387,41877,1329441
2019,Computer Science,893238,295819,89872,87121,47722,1413772
2020,Electrical,791707,332168,138694,76902,52555,1392026
2023,Electrical,884331,342680,130321,64839,77225,1499396
2022,Computer Science,728721,458929,96685,85373,43562,1413270
2022,Computer Science,706683,483699,91333,85306,36546,1403567
2019,Civil,863358,344792,91356,63896,55258,1418660
2021,Civil,886084,445982,120584,91525,41706,1585881
2019,Mechanical,644406,404557,131362,66198,58943,1305466
2020,Mechanical,747049,383932,91344,84524,52315,1359164
2021,Computer Science,835994,299875,124619,78651,40352,1379491
2020,Mechanical,787313,395991,81943,82636,64497,1412380
2023,Electrical,804573,479945,140217,84128,39609,1548472
2020,Computer Science,806205,323947,101021,77144,74974,1383291
2023,Computer Science,660481,259586,88348,68757,62786,1139958
2023,Electrical,838084,301986,96639,83963,57228,1377900
2020,Civil,889884,339848,144566,68515,79616,1522429
2020,Civil,874025,273055,122011,90777,38882,1398750
2023,Electrical,899140,415962,98640,72027,46268,1532037
2021,Electrical,763249,444153,115402,63792,35310,1421906
2023,Mechanical,722196,278807,145088,65777,76572,1288440
2022,Computer Science,637177,466992,140240,69794,54463,1368666
2023,Mechanical,666126,297177,81891,82544,41253,1168991
2021,Electrical,626119,475533,108259,68751,50404,1329066
2022,Mechanical,717744,318625,143021,81023,79314,1339727
2019,Electrical,716894,395314,108987,69727,39827,1330749
2019,Mechanical,758987,306317,132616,97793,40938,1336651
2021,Mechanical,644989,421050,90683,73665,63062,1293449
2023,Civil,884250,266433,141083,81126,55154,1428046
2020,Electrical,879275,283282,89967,69481,37240,1359245
2021,Mechanical,606553,326519,120194,75836,69612,1198714
2022,Computer Science,617881,490346,142661,84101,31585,1366574
2022,Mechanical,601379,293578,123452,73549,40541,1132499
2019,Mechanical,669306,380843,92857,95604,35427,1274037
2022,Computer Science,843825,358333,111301,53336,56747,1423542
2021,Electrical,704512,451279,135900,58157,53196,1403044
2022,Civil,878494,405205,111460,86155,45620,1526934
2021,Civil,699599,300317,129800,87481,79346,1296543
2020,Civil,681397,377878,89832,81567,39033,1269707
2019,Computer Science,617769,358745,127408,87869,61070,1252861
2022,Mechanical,778321,379230,92626,52431,76922,1379530
2021,Electrical,701584,315950,137872,83784,79104,1318294
2023,Mechanical,733858,309612,96802,67025,42199,1249496
2019,Civil,831609,314873,96333,70446,42776,1356037
2020,Mechanical,726525,494469,115120,58507,52727,1447348
2021,Computer Science,636303,365792,102159,83208,32931,1220393
2020,Computer Science,619589,467850,104660,67522,44843,1304464
2020,Electrical,865026,443074,136843,97402,35699,1578044
2022,Electrical,780394,433580,114519,75490,51224,1455207
2022,Civil,729236,481792,124935,88011,57321,1481295
2021,Electrical,871889,419451,102507,85071,37636,1516554
2023,Mechanical,615861,374814,137223,97754,31860,1257512
2021,Computer Science,691707,265231,107675,80413,44989,1190015
2023,Computer Science,855043,337385,97673,95102,78005,1463208
2020,Computer Science,733909,291163,115470,64040,67135,1271717
2019,Electrical,654380,371880,121603,88718,76422,1313003
2021,Computer Science,705025,412748,111230,57046,64939,1350988
2021,Computer Science,780903,337592,94542,89374,66062,1368473
2023,Computer Science,820421,356564,141407,86189,43801,1448382
2020,Civil,844497,466555,133821,96202,60398,1601473
2020,Civil,760592,305535,115690,68462,34747,1285026
2023,Electrical,644397,360952,86654,88871,67160,1248034
2020,Computer Science,877132,472648,147557,70534,35238,1603109
2022,Electrical,758795,427182,107446,84968,32834,1411225
2019,Computer Science,633800,428050,128484,70935,78203,1339472
2021,Computer Science,758502,471890,124078,90995,75676,1521141
2019,Computer Science,799548,472809,84225,59009,56230,1471821
2021,Electrical,857653,453441,125487,96989,37116,1570686
2022,Electrical,652284,385824,148676,96876,32928,1316588
2020,Computer Science,656232,274507,91721,51946,58179,1132585
2023,Mechanical,644420,466777,82587,86724,52134,1332642
2022,Electrical,899854,374225,119437,95311,69262,1558089
2019,Civil,692035,360282,98989,90483,64440,1306229
2023,Electrical,893427,422567,112726,53325,38190,1520235
2020,Computer Science,797241,471538,121168,58699,53828,1502474
2022,Mechanical,793529,441958,144669,53745,34350,1468251
2023,Computer Science,849863,320559,87408,95076,64055,1416961
2022,Civil,625968,250982,84153,94837,73686,1129626
2022,Electrical,662508,460913,91055,80794,46036,1341306
2020,Electrical,835863,379128,99760,74544,58700,1447995
2021,Computer Science,794292,397218,97752,71198,36610,1397070
2023,Computer Science,685366,497105,83800,63489,72018,1401778
2020,Civil,605738,435915,146573,96116,59420,1343762
2022,Mechanical,603098,326737,110054,72474,55177,1167540
2020,Civil,695424,332446,141816,68420,57850,1295956
2021,Mechanical,804705,338567,106866,52677,69651,1372466
2023,Electrical,678672,273636,80992,84512,41170,1158982
2021,Mechanical,739325,332850,103696,61175,79282,1316328
2019,Mechanical,725349,408404,140282,93318,70812,1438165
2023,Electrical,650969,432506,132838,92191,71070,1379574
2021,Electrical,690744,333866,109400,51177,57147,1242334
2022,Electrical,801495,442343,97565,50761,65502,1457666
2023,Civil,717286,312726,119585,87546,55406,1292549
2023,Electrical,675028,330901,114833,56458,31066,1208286
2020,Computer Science,897565,490109,92094,70110,34970,1584848
2022,Electrical,638575,391180,111280,92503,79436,1312974
2019,Electrical,603192,318896,126647,78253,53350,1180338
2021,Electrical,711116,423625,124378,68317,59235,1386671
2020,Mechanical,681311,290880,99513,78433,70562,1220699
2021,Civil,680781,495392,80154,57179,34114,1347620
2019,Electrical,636527,302077,108134,64849,58154,1169741
2019,Civil,652181,253625,88678,54444,75602,1124530
2023,Computer Science,691472,288237,86294,52964,79199,1198166
2019,Computer Science,681219,251223,89574,91990,68906,1182912
2021,Electrical,719783,440375,115183,62811,58890,1397042
2022,Computer Science,761554,315197,128747,60067,51245,1316810
2022,Civil,779300,486486,146606,89992,73038,1575422
2023,Mechanical,683265,324693,98638,60472,73266,1240334
2021,Electrical,650126,361555,137194,65126,54226,1268227
2021,Computer Science,882689,287760,127553,53101,66183,1417286
2019,Civil,655114,460254,106082,76990,42595,1341035
2021,Civil,806422,360174,96306,86665,57718,1407285
2020,Computer Science,788873,377192,87807,53678,69218,1376768
2019,Civil,876034,439038,131342,84611,55143,1586168
2020,Civil,721284,279024,112143,80729,76178,1269358
2023,Electrical,794469,451395,138414,79035,36164,1499477
2022,Civil,742290,273202,104715,65958,62640,1248805
2023,Computer Science,688241,369414,142054,74250,37787,1311746
2022,Electrical,896866,301524,92202,57083,45924,1393599
2023,Computer Science,782615,424980,107987,71756,75286,1462624
2021,Mechanical,630921,417139,115740,51466,50449,1265715
2020,Computer Science,761686,390432,133871,99887,30081,1415957
2022,Computer Science,792261,348228,93627,50339,33005,1317460
2019,Electrical,617601,354755,131069,94547,38408,1236380
2020,Civil,693332,394013,120409,71103,30334,1309191
2019,Computer Science,802615,265993,141486,67088,41103,1318285
2020,Electrical,835572,264620,81611,53724,71712,1307239
2020,Mechanical,890144,373271,111657,90957,74721,1540750
2023,Electrical,730439,270193,98462,71643,55169,1225906
2022,Electrical,839691,301559,118547,76044,60494,1396335
2022,Civil,719277,271248,109063,60334,73711,1233633
2020,Computer Science,892527,426924,132788,83320,53452,1589011
2021,Mechanical,742857,386099,122523,86259,56254,1393992
2021,Electrical,640910,313410,110284,50789,33897,1149290
2019,Computer Science,770100,254260,143996,83941,34648,1286945
2019,Computer Science,755927,287596,146247,50552,39674,1279996
2023,Electrical,886425,488148,93706,69806,47166,1585251
2020,Computer Science,604841,259012,90924,86979,56710,1098466
2019,Electrical,697204,275823,95921,58823,49970,1177741
2019,Electrical,660155,323851,105432,81980,33794,1205212
2020,Electrical,859589,297027,97813,99421,59184,1413034
2023,Mechanical,861140,459239,145250,50860,55559,1572048
2019,Electrical,748515,333794,148956,50290,45344,1326899
2023,Civil,732994,275099,82068,92417,75642,1258220
2022,Computer Science,894120,351427,119927,64344,68365,1498183
2023,Mechanical,743063,286992,110539,55870,61217,1257681
2021,Computer Science,704405,369942,91683,83397,69818,1319245
2021,Mechanical,653744,477984,115674,89775,35051,1372228
2023,Civil,602473,367886,132703,66186,47126,1216374
2021,Mechanical,739180,392049,138810,88711,34544,1393294
2022,Mechanical,628715,437306,91117,99626,42875,1299639
2020,Mechanical,844826,473302,83665,82265,34355,1518413
2021,Computer Science,853856,428448,124390,71016,49992,1527702
2021,Electrical,839419,415050,143887,54080,71053,1523489
2023,Computer Science,852508,259218,128266,62972,76076,1379040
2022,Electrical,899461,271788,135541,51760,61074,1419624
2020,Computer Science,764434,270501,144802,61274,32516,1273527
2023,Civil,654604,459061,87882,87476,52622,1341645
2023,Civil,604889,353733,93910,73304,75923,1201759
2022,Mechanical,820629,265210,120566,62166,79242,1347813
2020,Civil,894115,378476,143073,53398,78171,1547233
2022,Mechanical,650551,324225,116176,80625,31479,1203056
2020,Electrical,734273,426561,110289,97698,47338,1416159
2022,Civil,837230,473989,130411,60515,57007,1559152
2023,Electrical,836139,313721,149626,64705,70982,1435173
2023,Computer Science,708957,476116,95362,86329,75078,1441842
2019,Electrical,689882,423725,93783,60607,51836,1319833
2021,Computer Science,810323,467750,124162,80006,59246,1541487
2022,Electrical,867825,422022,115749,63018,32547,1501161
2019,Electrical,701982,389988,83554,59816,67691,1303031
2021,Civil,646870,446983,138568,70494,58130,1361045
2022,Electrical,813328,281449,98773,71237,79340,1344127
2020,Civil,759224,339333,146550,56831,78975,1380913
2021,Civil,650061,270782,126295,90963,30459,1168560
2023,Mechanical,788691,473636,110331,80541,32236,1485435
2019,Mechanical,658235,270243,125640,53447,50830,1158395
2021,Computer Science,690073,497446,144877,96448,30580,1459424
2021,Electrical,611217,279379,126969,55584,44439,1117588
2023,Computer Science,895885,287780,122986,77156,34715,1418522
2022,Electrical,792386,411812,87585,86559,56107,1434449
2020,Mechanical,863552,364944,84122,71465,55944,1440027
2023,Mechanical,642903,269984,96838,92120,61764,1163609
2020,Electrical,815280,250050,97301,67217,73394,1303242
2022,Electrical,707042,387662,103107,97466,57567,1352844
2021,Mechanical,843725,290205,137357,60190,68665,1400142
2020,Mechanical,732290,265162,135211,55335,62425,1250423
2019,Computer Science,781644,299746,146025,56260,71432,1355107
2019,Mechanical,709268,394177,146520,75778,47242,1372985
2023,Electrical,630105,418571,97344,65605,73949,1285574
2022,Computer Science,669634,417713,137202,68559,48824,1341932
2023,Electrical,738691,261628,94959,92341,41898,1229517
2023,Civil,618226,423104,118751,70557,64480,1295118
2023,Computer Science,625322,446101,81869,85556,79667,1318515
2019,Electrical,767284,288516,124264,93781,70123,1343968
2019,Mechanical,694835,337157,110268,95137,73353,1310750
2023,Civil,855027,382548,119606,74917,47759,1479857
2019,Electrical,673079,369558,93550,75937,53068,1265192
2022,Computer Science,623946,290800,85702,81538,33669,1115655
2023,Electrical,762812,285788,141745,56721,44382,1291448
2019,Civil,607253,370754,104459,70575,45436,1198477
2020,Computer Science,679311,471045,136782,57312,48774,1393224
2023,Civil,894957,276240,86032,97680,66030,1420939
2023,Electrical,667593,492060,81825,54616,34638,1330732
2022,Mechanical,749485,391994,128101,83763,32866,1386209
2021,Mechanical,826833,494762,140109,83124,39251,1584079
2021,Electrical,638485,314198,92470,74761,38948,1158862
2022,Electrical,799304,308739,83770,51693,52878,1296384
2022,Electrical,878245,454674,107268,52590,30187,1522964
2022,Computer Science,608831,262089,80029,80870,62270,1094089
2021,Civil,605004,282600,110083,59534,73341,1130562
2022,Civil,637170,427248,88958,57921,50962,1262259
2019,Civil,643555,258167,88806,51691,59911,1102130
2023,Electrical,718115,328352,112162,92042,49098,1299769
2023,Civil,778475,402236,114889,52904,37408,1385912
2020,Electrical,898509,335965,107702,94155,46679,1483010
2020,Computer Science,807132,375540,115777,94377,33533,1426359
2023,Mechanical,663471,481609,132971,89705,34140,1401896
2019,Electrical,657287,281415,87739,80956,66810,1174207
2021,Electrical,716475,454725,104599,68764,56618,1401181
2021,Mechanical,650151,493926,116827,58208,50654,1369766
2019,Mechanical,667384,321895,148446,65783,60775,1264283
2021,Computer Science,633541,329900,103039,58515,70501,1195496
2022,Civil,672847,483573,124929,52070,44676,1378095
2023,Electrical,818171,344330,123884,67314,36005,1389704
2023,Civil,811811,456901,105146,95514,35870,1505242
2019,Electrical,813739,308650,125819,63771,33904,1345883
2021,Computer Science,767813,440053,111308,81240,78235,1478649
2020,Mechanical,699919,455940,93054,95612,41973,1386498
2020,Computer Science,816746,250615,132018,67828,76976,1344183
2021,Mechanical,794020,426684,106250,94996,32261,1454211
2020,Civil,661768,327937,94413,74978,75813,1234909
2019,Civil,643262,497326,118921,70936,47804,1378249
2019,Computer Science,620605,291936,105785,76082,53077,1147485
2021,Mechanical,678590,410444,136865,67905,77276,1371080
2020,Computer Science,890375,357812,86861,53098,54680,1442826
2019,Mechanical,679397,494930,93979,77020,46862,1392188
2019,Mechanical,677123,317875,146833,68952,51902,1262685
2022,Civil,875659,331782,80357,60985,69345,1418128
2022,Civil,878744,311700,127201,58283,69553,1445481
2019,Mechanical,758964,258109,134254,96323,38884,1286534
2021,Mechanical,768767,273758,90796,87708,33038,1254067
2023,Mechanical,735501,469699,103238,54762,62961,1426161
2023,Civil,735678,358592,130978,84521,61562,1371331
2019,Civil,714380,263317,120883,55054,56065,1209699
2019,Electrical,771206,463370,149396,63276,62084,1509332
2019,Mechanical,756547,450073,84447,55781,79210,1426058
2021,Electrical,752802,432495,100523,66471,41801,1394092
2022,Mechanical,752185,275622,144079,68025,50957,1290868
2019,Civil,751083,496767,144823,85730,32580,1510983
2019,Electrical,655746,256800,129289,55413,56544,1153792
2020,Electrical,773925,495869,84849,57420,75647,1487710
2021,Computer Science,898962,285539,104718,91510,75013,1455742
2019,Mechanical,768393,483259,140977,93406,62454,1548489
2020,Civil,883453,383672,107135,89678,76401,1540339
2023,Computer Science,890320,452126,110262,76527,41277,1570512
2019,Computer Science,668879,335163,114787,93250,70391,1282470
2019,Mechanical,667592,496765,95689,62029,62988,1385063
2020,Computer Science,820084,410441,119860,91583,30875,1472843
2021,Mechanical,797494,478053,130344,86525,41654,1534070
2019,Computer Science,870728,266689,147891,87564,31196,1404068
2023,Mechanical,724555,331459,131658,86060,79487,1353219
2019,Civil,618830,288469,145869,53832,71184,1178184
2023,Mechanical,816897,477011,115330,52611,53398,1515247
2022,Mechanical,852234,382030,140064,58353,44370,1477051
2022,Electrical,865735,486971,107014,93042,58517,1611279
2023,Civil,693878,310012,114563,77589,58859,1254901
2021,Civil,725407,450146,95270,90996,31247,1393066
2019,Civil,716869,310021,111279,75421,54564,1268154
2019,Computer Science,857716,470012,83657,61068,76018,1548471
2022,Electrical,883539,431854,148773,53346,37111,1554623
2023,Civil,616738,456591,81027,86822,50973,1292151
2019,Computer Science,733703,481979,94199,98760,64654,1473295
2019,Computer Science,748977,440387,124954,54200,30310,1398828
2021,Computer Science,619056,274642,95120,97259,40760,1126837
2020,Electrical,840746,329003,136812,58527,47988,1413076
2022,Computer Science,715316,373714,85983,97013,52043,1324069
2022,Electrical,766519,250205,146629,60535,54944,1278832
2020,Mechanical,654418,342945,82912,67944,66314,1214533
2019,Computer Science,899334,262442,127879,90290,68119,1448064
2021,Civil,626014,341826,101873,95941,54401,1220055
2021,Computer Science,804071,472716,94332,54164,47381,1472664
2022,Mechanical,838989,386763,96564,80022,63264,1465602
2021,Mechanical,781350,288909,100526,62438,52069,1285292
2020,Computer Science,863924,498905,145481,73104,72964,1654378
2019,Mechanical,790330,269504,132775,54852,31198,1278659
2020,Electrical,642192,445342,96006,56713,73305,1313558
2023,Electrical,643923,345698,101643,53183,35910,1180357
2022,Computer Science,689196,486104,143128,81354,35484,1435266
2021,Electrical,602395,439123,122523,58032,76165,1298238
2023,Electrical,828456,419870,132784,64275,30576,1475961
2021,Civil,671028,430402,139701,68793,62821,1372745
2019,Computer Science,842463,337087,97946,87066,78757,1443319
2019,Mechanical,741056,459991,93127,68918,74392,1437484
2019,Computer Science,803400,463104,109404,55599,78603,1510110
2021,Electrical,855315,291716,97401,82771,62996,1390199
2023,Civil,889068,455696,95428,63440,55354,1558986
2019,Computer Science,894721,428054,144372,61289,78958,1607394
2023,Computer Science,738783,408516,91971,93808,60229,1393307
2021,Electrical,685548,405806,96565,96032,42022,1325973
2023,Electrical,857288,422817,86829,99178,30984,1497096
2021,Computer Science,725093,284571,115435,55161,42660,1222920
2021,Electrical,835835,473023,118941,50964,55044,1533807
2022,Electrical,806084,396461,122459,65942,48851,1439797
2021,Electrical,870398,343280,127976,99223,72809,1513686
2021,Electrical,829027,465290,89176,88369,63299,1535161
2020,Electrical,808072,295038,131516,64184,43711,1342521
2019,Civil,848029,480918,95072,52947,41227,1518193
2022,Electrical,809047,322795,99689,93275,38028,1362834
2022,Mechanical,730509,295168,98599,94857,46945,1266078
2022,Computer Science,837784,459154,115388,56238,62857,1531421
2020,Civil,895107,317690,130603,63156,68503,1475059
2021,Civil,603273,455374,105789,52411,55982,1272829
2019,Electrical,615330,364053,132282,65674,65913,1243252
2023,Computer Science,752566,261230,113464,58308,31292,1216860
2021,Mechanical,676422,333301,147806,93171,53880,1304580
2020,Electrical,603212,386974,121994,52924,62538,1227642
2021,Computer Science,832131,316758,105594,85605,37559,1377647
2021,Electrical,687594,277050,132563,50576,66549,1214332
2020,Electrical,732152,349805,108386,64641,65159,1320143
2022,Electrical,894819,455658,146652,58963,51539,1607631
2022,Electrical,622007,495584,97540,74291,43204,1332626
2019,Electrical,713805,319110,113756,91159,32252,1270082
2019,Electrical,695815,352033,123426,82728,66659,1320661
2022,Electrical,862783,326693,85587,91139,39866,1406068
2023,Mechanical,678038,372428,129039,68789,79927,1328221
2021,Civil,865880,269575,90269,89651,67997,1383372
2023,Mechanical,853506,440012,86088,77899,54800,1512305
2021,Electrical,616473,290244,122044,65658,37553,1131972
2022,Electrical,728771,464553,107081,88907,62831,1452143
2019,Mechanical,725801,264962,141388,64184,31787,1228122
2019,Mechanical,686623,481898,90543,81747,74810,1415621
2023,Civil,825097,350695,83005,62965,70837,1392599
2019,Mechanical,898964,498435,117203,60493,41726,1616821
2022,Civil,815933,497943,96220,76178,33915,1520189
2023,Electrical,796879,340388,112696,83887,77423,1411273
2021,Computer Science,880558,477292,126381,52214,75412,1611857
2019,Computer Science,624220,491450,127984,58000,30092,1331746
2020,Computer Science,660531,327332,80076,58065,40934,1166938
2019,Computer Science,773497,405522,98946,92871,59995,1430831
2021,Electrical,609387,481454,103471,51085,62469,1307866
2023,Computer Science,845752,434566,141531,99325,31677,1552851
2021,Mechanical,676815,377386,118738,96332,58242,1327513
2020,Mechanical,627584,295037,120720,53532,51892,1148765
2022,Computer Science,644783,362666,104440,67622,52114,1231625
2019,Mechanical,770881,377048,91862,54834,66632,1361257
2023,Civil,785399,333040,148273,70197,57057,1393966
2022,Electrical,724494,361264,101788,62008,74916,1324470
2021,Computer Science,715814,411113,105522,62962,74031,1369442
2023,Computer Science,850139,260715,149404,97229,77881,1435368
2022,Electrical,741929,402875,132289,97356,67355,1441804
2023,Mechanical,773333,449978,87824,58012,61532,1430679
2020,Electrical,846509,311726,87799,70166,40169,1356369
2020,Electrical,613580,382980,125147,68628,64566,1254901
2019,Mechanical,618240,368208,88614,59849,76550,1211461
2019,Electrical,854351,418147,105147,91372,60740,1529757
2020,Mechanical,854271,445659,100914,63767,76176,1540787
2023,Mechanical,680974,303648,143699,65111,40030,1233462
2020,Electrical,673401,271134,89615,89989,40752,1164891
2019,Civil,813165,490673,130785,90582,37051,1562256
2020,Mechanical,764340,496257,137811,94370,72623,1565401
2020,Electrical,865790,306143,126898,95052,40589,1434472
2023,Mechanical,786443,319123,135505,98278,41395,1380744
2022,Civil,848123,476631,80146,83891,42833,1531624
2019,Civil,689460,426225,120275,95289,30598,1361847
2023,Computer Science,651048,383485,95977,71565,44367,1246442
2020,Mechanical,806518,499560,121565,85011,48428,1561082
2020,Mechanical,732850,471646,113945,52589,46642,1417672
2022,Electrical,811912,403627,82594,92738,50955,1441826
2019,Mechanical,866891,392024,137655,97398,70771,1564739
2019,Computer Science,600045,450065,107431,94482,40097,1292120
2021,Civil,607758,455072,107571,59749,43207,1273357
2019,Civil,855397,371657,145971,72683,52560,1498268
2022,Computer Science,754509,316686,141797,54501,53426,1320919
2021,Mechanical,750657,362841,123937,73423,74592,1385450
2021,Mechanical,740926,282264,139643,69157,30797,1262787
2020,Computer Science,783148,486830,140051,69169,73463,1552661
2020,Electrical,748421,428625,147902,73324,35713,1433985
2019,Civil,827300,435431,148951,51706,70079,1533467
2021,Computer Science,752420,359885,109039,78219,50404,1349967
2020,Computer Science,765368,479394,105568,91334,35911,1477575
2022,Mechanical,619455,390880,117459,51612,33954,1213360
2020,Civil,809896,302330,87669,66838,72587,1339320
2020,Mechanical,831897,364672,115516,87065,34312,1433462
2021,Computer Science,688552,288345,142484,80427,60875,1260683
2021,Electrical,640484,450689,148197,65546,71748,1376664
2023,Civil,734476,289222,103333,98735,48440,1274206
2022,Computer Science,768332,307755,135611,59045,45828,1316571
2021,Computer Science,700647,258933,127941,75299,60898,1223718
2019,Electrical,665642,318207,118875,51391,76720,1230835
2022,Computer Science,811803,424811,92698,93347,69870,1492529
2022,Computer Science,728824,428810,141826,91221,75428,1466109
2021,Civil,848914,477825,111408,90776,45427,1574350
2022,Civil,891749,354691,95133,82667,59641,1483881
2021,Civil,710879,355137,116126,65948,52169,1300259
2020,Mechanical,720827,465616,113043,75118,64215,1438819
2023,Electrical,867724,402955,84078,88193,79666,1522616
2020,Civil,867544,348818,133906,64157,75419,1489844
2021,Mechanical,770715,348510,91137,67021,77880,1355263
2021,Mechanical,827257,349251,109350,58356,31951,1376165
2020,Electrical,727319,424473,84698,85573,51954,1374017
2019,Electrical,706960,396452,113132,98215,43827,1358586
2019,Computer Science,639015,268212,90165,51223,38965,1087580
2019,Mechanical,803877,278174,80794,86110,63096,1312051
2021,Civil,745109,387933,93646,74626,38985,1340299
2022,Electrical,862063,387166,85870,99640,62641,1497380
2021,Mechanical,688754,354649,110736,80917,52897,1287953
2022,Civil,821775,301319,138084,71526,75652,1408356
2020,Mechanical,803225,427800,96211,58856,35973,1422065
2023,Electrical,752606,405435,139538,88829,47794,1434202
2022,Computer Science,822067,337846,87377,63532,37714,1348536
2019,Mechanical,656879,420372,88861,70745,31137,1267994
2021,Civil,719894,304808,97821,70336,67240,1260099
2020,Electrical,665839,387015,106953,80796,66042,1306645
2019,Computer Science,629756,461177,116801,77167,33273,1318174
2020,Civil,743755,292616,98277,50880,52627,1238155
2023,Civil,780557,324329,102628,66818,62193,1336525
2021,Civil,829303,484815,107802,88892,45151,1555963
2021,Mechanical,749787,406359,143497,74488,40155,1414286
2023,Electrical,692943,377957,149814,87952,56741,1365407
2021,Civil,818188,415043,133702,68368,52948,1488249
2022,Mechanical,748188,306152,108677,79028,68130,1310175
2020,Electrical,636744,292351,87500,63223,34636,1114454
2019,Electrical,724697,493787,84015,81395,68114,1452008
2023,Mechanical,716072,441112,138812,80261,61649,1437906
2022,Mechanical,836028,477977,87826,59984,73706,1535521
2019,Civil,769123,469631,89201,52798,66976,1447729
2019,Electrical,607176,372377,109048,57603,67236,1213440
2023,Computer Science,852365,310616,99941,96051,32346,1391319
2022,Mechanical,749748,492493,138418,61704,43984,1486347
2019,Electrical,645177,404969,145689,96088,31042,1322965
2019,Electrical,710623,273010,121541,84261,43063,1232498
2022,Civil,600997,421226,129939,65707,50490,1268359
2021,Computer Science,720179,482507,103950,68009,70967,1445612
2019,Civil,847439,371822,147803,68231,66499,1501794
2020,Computer Science,720403,401186,100642,53246,72533,1348010
2022,Computer Science,695287,269050,146506,79825,37302,1227970
2019,Mechanical,719574,496309,121607,65925,51876,1455291
2023,Electrical,856463,271125,111288,51316,79612,1369804
2020,Electrical,721509,475166,94450,68334,46294,1405753
2019,Electrical,848505,431468,85618,81072,32302,1478965
2020,Computer Science,792589,425918,114263,99375,49017,1481162
2020,Electrical,889531,401468,147583,52026,72311,1562919
2021,Mechanical,604090,342661,108794,51547,30361,1137453
2020,Computer Science,603743,338116,93091,65289,68261,1168500
2021,Computer Science,630924,369233,148422,86546,47171,1282296
2022,Computer Science,741268,420045,95161,98886,79360,1434720
2021,Computer Science,705312,404646,84158,89279,71226,1354621
2023,Mechanical,816249,340155,107663,72169,59327,1395563
2019,Electrical,824090,379843,86733,90525,35092,1416283
2022,Mechanical,829602,263869,112001,70107,46937,1322516
2022,Electrical,703976,447266,119128,84291,70793,1425454
2023,Mechanical,755183,312167,129630,77279,43817,1318076
2021,Civil,713566,437219,89329,68356,39779,1348249
2019,Civil,857443,493758,133105,95488,34516,1614310
2021,Civil,719968,393194,143436,80043,69219,1405860
2020,Civil,661600,424899,149579,96342,60114,1392534
2021,Computer Science,650022,394407,94242,79966,44530,1263167
2022,Computer Science,734271,313576,107133,62795,39310,1257085
2019,Mechanical,723323,271677,104740,67000,64281,1231021
2021,Mechanical,786110,409295,110976,70899,53809,1431089
2019,Civil,720278,410886,120067,71575,76104,1398910
2019,Electrical,870041,375662,91231,72158,51735,1460827
2020,Civil,664541,464683,146105,98630,74363,1448322
2020,Mechanical,706968,424257,83328,69005,36749,1320307
2022,Civil,614892,326794,105261,95201,57637,1199785
2023,Mechanical,624815,477135,105262,68477,37005,1312694
2019,Civil,878411,325675,83280,69560,59898,1416824
2023,Electrical,880412,292325,111742,75708,53538,1413725
2022,Civil,714463,290503,83590,90252,67206,1246014
2019,Electrical,790732,269514,130226,95176,75648,1361296
2019,Electrical,796599,306196,93570,69954,51708,1318027
2023,Mechanical,794451,401989,89533,80635,75024,1441632
2021,Electrical,772343,435771,93366,68530,72944,1442954
2020,Computer Science,738307,344633,108325,50705,55467,1297437
2021,Computer Science,688757,431191,114798,96293,79127,1410166
2023,Computer Science,896753,333324,119453,86580,44412,1480522
2020,Mechanical,854200,406133,102849,77046,59378,1499606
2021,Computer Science,623645,391019,135943,94420,77055,1322082
2020,Mechanical,795630,462152,86157,70152,58102,1472193
2019,Mechanical,754473,335550,110178,81855,43044,1325100
2021,Computer Science,869915,330331,109030,52319,61309,1422904
2020,Electrical,751460,413704,131134,58163,48239,1402700
2020,Civil,683251,400424,145729,71605,32435,1333444
2020,Mechanical,657042,273653,88164,50209,73934,1143002
2021,Computer Science,796945,448187,81119,54834,53164,1434249
2022,Mechanical,647024,347294,93351,81512,65866,1235047
2021,Electrical,754522,293755,136063,62446,33386,1280172
2023,Electrical,656965,354296,125162,53962,35440,1225825
2021,Computer Science,872201,348354,111760,63028,75503,1470846
2020,Mechanical,824321,321988,129678,71903,72776,1420666
2019,Civil,871127,287921,127628,61717,36436,1384829
2021,Civil,619995,440075,120739,87562,37403,1305774
2021,Mechanical,714587,461948,109738,80545,53242,1420060
2020,Mechanical,833076,296668,126921,98997,73464,1429126
2019,Mechanical,822700,305175,141068,85212,32939,1387094
2019,Computer Science,638886,428810,103581,93543,47222,1312042
2023,Electrical,695149,303452,101485,91100,57277,1248463
2021,Civil,694020,449395,116294,85375,51143,1396227
2019,Computer Science,602673,296149,133001,70320,33138,1135281
2019,Mechanical,623466,494965,81634,69301,79327,1348693
2022,Mechanical,837626,265839,123969,68181,50989,1346604
2022,Electrical,650406,252155,80093,59168,33162,1074984
2019,Mechanical,669284,388091,108370,52573,32752,1251070
2023,Computer Science,835718,304512,99750,68973,55765,1364718
2019,Computer Science,613665,442762,96472,86051,75657,1314607
2020,Electrical,620641,336150,98934,92759,30837,1179321
2021,Computer Science,635797,376041,123774,70801,58474,1264887
2023,Civil,815838,276190,119125,78644,42043,1331840
2020,Computer Science,702339,486983,146981,77523,78565,1492391
2023,Computer Science,713431,260928,119103,83481,77154,1254097
2020,Computer Science,832275,298425,140085,68807,65501,1405093
2021,Civil,883317,324134,136543,51890,74770,1470654
2021,Mechanical,744294,359875,96938,69951,77369,1348427
2022,Computer Science,781136,467189,131586,55375,54072,1489358
2020,Electrical,768082,374264,138024,81305,67974,1429649
2022,Civil,853301,430046,119687,65579,32653,1501266
2020,Electrical,618095,360191,106207,59870,52524,1196887
2022,Computer Science,723554,428868,129354,68531,49733,1400040
2021,Electrical,834989,429815,117310,59109,66078,1507301
2023,Computer Science,689023,493215,128960,76842,67448,1455488
2022,Civil,707181,460527,141262,60716,48770,1418456
2020,Electrical,822310,353716,93403,68190,67959,1405578
2020,Electrical,882744,451107,93065,98585,79525,1605026
2021,Computer Science,864610,418749,106801,86819,67443,1544422
2020,Computer Science,856349,306321,109230,82433,42804,1397137
2019,Mechanical,776169,363782,109968,91519,46210,1387648
2023,Computer Science,653276,359398,122517,75204,64029,1274424
2022,Computer Science,869072,308973,133239,96408,37633,1445325
2023,Mechanical,805719,302414,112655,92871,38312,1351971
2021,Computer Science,771960,406674,142771,86530,68300,1476235
2022,Computer Science,826097,498749,125984,94511,50229,1595570
2022,Mechanical,774904,279692,91049,76384,32884,1254913
2019,Civil,716196,355958,144813,60087,73577,1350631
2021,Civil,609404,298750,84655,62122,50522,1105453
2020,Computer Science,809190,497984,148972,80898,35623,1572667
2019,Computer Science,713187,402832,101432,65841,41460,1324752
2019,Mechanical,627684,318456,145896,75582,40234,1207852
2023,Mechanical,668591,274085,122936,60042,48503,1174157
2023,Civil,808794,445036,93750,76505,54100,1478185
2023,Electrical,864826,272925,107987,73294,46874,1365906
2019,Computer Science,711186,255615,106165,56173,76905,1206044
2020,Electrical,843181,287083,130541,68516,59420,1388741
2022,Electrical,621832,360764,104346,56932,65813,1209687
2023,Mechanical,616997,449391,83514,67909,30382,1248193
2020,Computer Science,896784,259605,104838,80241,79956,1421424
2021,Computer Science,640491,361093,107559,66712,68353,1244208
2023,Mechanical,663043,294608,139207,52657,39369,1188884
2022,Electrical,728568,378788,96385,79105,64985,1347831
2021,Mechanical,672725,269192,98317,91547,72255,1204036
2021,Civil,728131,384403,80393,80382,53661,1326970
2022,Computer Science,645520,301330,104881,72356,75486,1199573
2023,Civil,709869,478464,107955,69589,77883,1443760
2019,Mechanical,664442,299949,138308,89601,30650,1222950
2022,Computer Science,861025,318382,138014,73916,70937,1462274
2022,Civil,752842,349233,145430,90675,51299,1389479
2022,Civil,778570,418658,139596,84366,56862,1478052
2021,Electrical,723447,302243,81713,53851,61153,1222407
2020,Computer Science,661477,350566,100428,77048,46312,1235831
2019,Civil,600244,308618,142160,57582,40943,1149547
2023,Civil,777561,459383,146171,93777,33198,1510090
2023,Electrical,890534,388621,140843,90591,47325,1557914
2020,Civil,610247,368168,103003,54607,38732,1174757
2022,Civil,800123,302494,122077,55507,35805,1316006
2019,Civil,790791,469045,106730,55934,48913,1471413
2023,Electrical,807358,273958,145573,91971,31202,1350062
2023,Civil,891727,470851,108869,71952,47034,1590433
2022,Civil,739148,488785,111076,54659,33006,1426674
2020,Computer Science,746123,357960,105094,54398,38505,1302080
2019,Computer Science,628670,475592,106817,56242,50498,1317819
2020,Electrical,610236,352478,90555,78620,72143,1204032
2020,Mechanical,635568,418610,130193,75905,75873,1336149
2019,Computer Science,707327,255833,84715,60796,46505,1155176
2019,Electrical,855745,404458,114162,97145,36603,1508113
2023,Civil,878496,498053,118458,89379,54744,1639130
2023,Civil,725721,481421,83140,97543,33682,1421507
2019,Electrical,859291,349341,97383,89480,43460,1438955
2021,Civil,756228,452850,97718,87275,43559,1437630
2023,Civil,655904,344240,137399,63937,58544,1260024
2021,Mechanical,878252,357955,101863,81531,36864,1456465
2019,Civil,864997,405904,91377,69569,53778,1485625
2023,Computer Science,866320,458929,140523,62343,44234,1572349
2020,Civil,700459,420002,94870,96803,58593,1370727
2019,Electrical,785922,413479,137487,61533,74657,1473078
2022,Mechanical,737901,254073,99300,99347,31729,1222350
2021,Civil,723225,267667,135951,81132,74515,1282490
2019,Electrical,835847,397107,147639,81356,52336,1514285
2019,Computer Science,821738,256732,122980,65438,64936,1331824
2023,Civil,710893,305097,112050,76366,42413,1246819
2023,Mechanical,842726,253487,82921,63968,77652,1320754
2023,Civil,796914,481560,110328,67490,59764,1516056
2022,Electrical,781880,307702,140820,69173,75741,1375316
2023,Mechanical,606611,344961,103138,60376,37668,1152754
2019,Civil,847524,493266,92094,75114,43260,1551258
2023,Computer Science,895187,335107,145264,71168,41308,1488034
2020,Mechanical,736343,410147,89028,50718,38896,1325132
2023,Computer Science,790191,357721,95432,89844,69408,1402596
2022,Electrical,742645,321031,123819,86763,49283,1323541
2020,Civil,752481,334217,85312,50305,49591,1271906
2019,Computer Science,886608,264781,105973,71814,55282,1384458
2019,Electrical,849220,289865,135305,91347,43919,1409656
2021,Civil,718523,258469,108973,91684,37674,1215323
2020,Electrical,620662,295167,124390,80711,60699,1181629
2021,Computer Science,880372,462810,96099,64177,60840,1564298
2020,Electrical,660721,269928,129956,95970,48392,1204967
2020,Mechanical,738458,457593,94063,74570,61960,1426644
2022,Civil,869006,289599,89605,85364,34721,1368295
2021,Electrical,640108,397847,131205,97609,59197,1325966
2022,Computer Science,691788,316504,95817,68819,56173,1229101
2020,Civil,844437,456990,82420,81391,31066,1496304
2019,Mechanical,837011,320687,149853,65788,72906,1446245
2020,Civil,758273,407876,107728,98651,57375,1429903
2022,Mechanical,649966,359122,137858,59896,31918,1238760
2021,Civil,785846,413331,129089,70559,39457,1438282
2021,Electrical,872530,336284,108964,73565,40726,1432069
2022,Electrical,677228,335227,122240,70926,44282,1249903
2021,Computer Science,746297,347556,92675,63376,54815,1304719
2023,Mechanical,643021,293560,140049,71875,52594,1201099
2019,Computer Science,749333,277256,128436,97606,37448,1290079
2019,Electrical,852646,256125,120213,62857,31142,1322983
2019,Mechanical,686755,254370,108111,51283,50232,1150751
2021,Computer Science,666330,254838,84284,64920,31415,1101787
2021,Computer Science,778438,364479,97585,50247,36374,1327123
2020,Computer Science,645313,307429,145039,80846,56974,1235601
2020,Computer Science,834729,384206,87131,56642,63528,1426236
2019,Computer Science,832783,492067,123382,67365,33642,1549239
2023,Mechanical,889176,293199,113527,87131,47936,1430969
2020,Computer Science,748430,327092,110936,96719,61914,1345091
2020,Mechanical,628365,374925,133441,67949,39347,1244027
2021,Computer Science,875333,414894,134598,83503,54932,1563260
2023,Electrical,607248,474585,100642,60851,53593,1296919
2019,Electrical,604369,270113,149907,64406,31328,1120123
2020,Computer Science,890749,444666,92651,64928,48760,1541754
2023,Civil,771955,346102,81665,66832,49625,1316179
2023,Electrical,633055,252669,86918,57534,56567,1086743
2019,Mechanical,799803,430499,103007,51835,42063,1427207
2023,Computer Science,869594,462689,105035,54715,61630,1553663
2023,Mechanical,733997,394010,102211,83381,56961,1370560
2023,Civil,650272,386789,134587,72618,33140,1277406
2020,Computer Science,605310,327818,106866,50876,47265,1138135
2019,Electrical,631817,428731,87344,93535,38730,1280157
2023,Mechanical,815888,488673,148737,59325,44057,1556680
2023,Electrical,682641,445647,142546,79446,33557,1383837
2020,Electrical,815155,329737,90327,83439,59114,1377772
2019,Computer Science,807382,397361,128659,51630,43211,1428243
2021,Mechanical,615457,274406,125797,83128,77154,1175942
2020,Civil,642311,477894,107608,64713,48580,1341106
2019,Electrical,751958,262873,108285,60584,48334,1232034
2023,Computer Science,723573,375812,128634,53901,39802,1321722
2019,Computer Science,898325,332048,120289,99949,52321,1502932
2019,Civil,764334,475535,98007,97558,65931,1501365
2019,Computer Science,863272,273461,105257,66450,67231,1375671
2021,Electrical,679522,401782,109784,77610,34007,1302705
2019,Computer Science,763394,466560,118588,72061,34675,1455278
2021,Mechanical,648929,263448,124221,65314,44058,1145970
2023,Mechanical,681696,265198,101378,52090,79001,1179363
2021,Electrical,871952,323158,84696,76852,67519,1424177
2023,Mechanical,695148,487456,114635,72454,36219,1405912
2023,Civil,883869,449010,138543,61707,45445,1578574
2021,Computer Science,820026,431871,99207,81567,38418,1471089
2020,Electrical,683576,482932,107524,83823,53914,1411769
2022,Civil,620557,475075,108554,82007,59630,1345823
2019,Computer Science,621825,416033,91817,89024,70503,1289202
2022,Civil,871142,424079,135258,64141,71551,1566171
2019,Electrical,636080,315470,142582,62746,58695,1215573
2019,Electrical,858815,433328,80168,53347,60434,1486092
2023,Civil,788869,270739,122981,59361,44456,1286406
2019,Computer Science,746874,334054,145199,96436,60185,1382748
2019,Mechanical,642407,308186,144948,54101,54156,1203798
2021,Mechanical,720283,276547,137782,90275,75908,1300795
2022,Civil,613338,344472,141599,98095,73631,1271135
2021,Electrical,676289,335823,96291,91453,77993,1277849
2019,Computer Science,749967,499373,133833,85947,32078,1501198
2023,Computer Science,778982,356887,112992,82668,60350,1391879
2021,Electrical,709367,432503,119350,94803,74910,1430933
2021,Mechanical,717486,406548,81573,79610,42073,1327290
2020,Computer Science,814209,459483,88577,67747,53778,1483794
2019,Civil,856055,260686,88712,65009,53397,1323859
2023,Mechanical,736421,398608,109948,73651,33321,1351949
2021,Civil,753535,284062,85217,94358,42337,1259509
2021,Mechanical,674935,298216,140178,51056,77829,1242214
2023,Electrical,789864,406113,106409,82910,36011,1421307
2019,Civil,875830,281653,129040,61507,69855,1417885
2020,Civil,663528,271673,147035,71215,39996,1193447
2021,Electrical,699811,391439,89669,77349,64498,1322766
2020,Civil,884931,269629,138247,80375,76845,1450027
2022,Mechanical,788499,370756,138975,60076,50046,1408352
2019,Computer Science,860141,361641,108562,95005,51494,1476843
2022,Computer Science,704887,469708,101629,85249,36618,1398091
2022,Electrical,661086,453262,141463,60082,36899,1352792
2022,Mechanical,855494,275063,126007,90664,61322,1408550
2019,Civil,663308,269322,98128,69509,63797,1164064
2019,Civil,877941,465618,82039,57050,45128,1527776
2023,Computer Science,867446,496709,83857,88779,63179,1599970
2020,Civil,638059,262693,139019,98098,31981,1169850
2020,Computer Science,731980,390313,92735,61414,72307,1348749
2023,Electrical,791324,410850,114511,86918,64073,1467676
2023,Civil,743949,352379,126051,65876,42478,1330733
2022,Mechanical,876383,262651,132693,57004,76014,1404745
2023,Civil,627313,407038,149152,59198,56429,1299130
2021,Computer Science,642103,259275,109756,77766,67363,1156263
2020,Electrical,779480,295606,83894,83988,79967,1322935
2023,Computer Science,688771,251658,123232,87429,41697,1192787
2021,Civil,726228,475571,133214,87634,45422,1468069
2021,Computer Science,691665,322468,149817,51797,72436,1288183
2021,Computer Science,872678,395320,143862,88742,68380,1568982
2021,Electrical,879333,405509,110036,63165,60341,1518384
2022,Mechanical,686067,420799,98584,69255,32037,1306742
2021,Civil,873111,399273,112308,89773,39522,1513987
2022,Electrical,813063,291150,108333,54612,51259,1318417
2022,Mechanical,870804,496220,115949,75280,41998,1600251
2021,Computer Science,729909,470963,119288,92633,37086,1449879
2020,Mechanical,740688,264999,125267,81528,31149,1243631
2021,Computer Science,675976,256376,112175,94659,52792,1191978
2021,Computer Science,833208,301673,88915,60283,46390,1330469
2021,Electrical,779810,253476,139722,54953,64204,1292165
2020,Computer Science,875251,498465,145298,70698,66018,1655730
2019,Electrical,792476,319902,93805,89819,58115,1354117
2019,Mechanical,694182,495582,120517,95313,54047,1459641
2022,Mechanical,843153,341269,134716,72016,47078,1438232
2022,Computer Science,878098,459066,82871,63248,51471,1534754
2020,Electrical,879087,443950,117375,67276,44263,1551951
2023,Computer Science,640725,348331,125741,81008,34843,1230648
2019,Electrical,610110,401687,103148,82213,42433,1239591
2022,Electrical,878606,261164,85834,67355,41559,1334518
2019,Electrical,785153,289316,122680,66486,34952,1298587
2020,Mechanical,666567,449632,83399,65139,70610,1335347
2020,Electrical,782296,410631,144091,98276,62793,1498087
2023,Mechanical,713394,312968,101762,71529,50931,1250584
2023,Electrical,748940,447872,131009,86014,32153,1445988
2020,Mechanical,622222,390119,131548,70096,58911,1272896
2022,Civil,679794,426057,108340,80117,38019,1332327
2019,Mechanical,663924,453195,141365,96733,49873,1405090
2021,Mechanical,699854,387649,139790,53417,71291,1352001
2023,Computer Science,860038,464243,147797,56445,61631,1590154
2021,Electrical,843815,492172,91809,55417,67929,1551142
2022,Civil,833127,384942,97696,65494,47028,1428287
2023,Computer Science,741295,284094,131457,96134,64620,1317600
2021,Electrical,779238,305329,101891,63302,70491,1320251
2022,Civil,639369,390289,139151,86427,78474,1333710
2019,Civil,874805,496121,143008,90274,40623,1644831
2022,Civil,746663,333138,132488,82098,49968,1344355
2023,Electrical,786307,316141,136632,78803,33809,1351692
2020,Civil,870114,403415,146533,79164,64079,1563305
2019,Civil,647922,378307,137942,88441,57371,1309983
2021,Computer Science,892899,431894,89275,84925,73966,1572959
2023,Mechanical,720926,394075,99965,99733,69006,1383705
2020,Electrical,619416,489865,115854,83563,61739,1370437
2022,Mechanical,613672,440610,95973,61389,37788,1249432
2020,Computer Science,728145,413161,106878,94327,36977,1379488
2023,Mechanical,778068,434667,97105,63490,69177,1442507
2023,Civil,600064,333197,144746,56044,64838,1198889
2020,Civil,668835,332318,119935,91769,32656,1245513
2022,Electrical,801457,411101,112784,77509,34134,1436985
2020,Electrical,847795,329023,111601,77844,59431,1425694
2023,Electrical,716916,432396,119865,71604,33484,1374265
2023,Computer Science,795346,301962,98616,77560,79565,1353049
2021,Electrical,873010,363037,91654,50572,73622,1451895
2021,Computer Science,603889,420114,97830,51206,77312,1250351
2019,Civil,718194,337601,96205,99051,75077,1326128
2023,Mechanical,724714,457452,122425,63096,68916,1436603
2021,Civil,631335,334859,115851,79550,57274,1218869
2020,Civil,650547,340933,86952,85228,50693,1214353
2022,Civil,757234,295957,127405,70389,68559,1319544
2020,Electrical,820521,332864,85391,87693,47303,1373772
2022,Electrical,755759,376358,142468,68997,49594,1393176
2021,Electrical,873139,293739,95091,84483,49103,1395555
2019,Mechanical,602631,288733,110237,97207,41858,1140666
2020,Electrical,737039,295389,138353,71629,45002,1287412
2020,Computer Science,664471,410787,120682,84337,34895,1315172
2020,Civil,899260,420188,129634,67060,73324,1589466
2022,Mechanical,733014,306922,106968,96000,79944,1322848
2021,Mechanical,647664,437323,134833,92793,55151,1367764
2020,Mechanical,759141,442866,120205,64605,39919,1426736
2020,Mechanical,687342,267580,122541,85281,74187,1236931
2019,Mechanical,614407,365900,108285,91760,51927,1232279
2019,Computer Science,713926,381895,132513,59333,58147,1345814
2021,Civil,813053,473080,95430,98993,42378,1522934
2021,Mechanical,617878,257084,89033,79787,66493,1110275
2023,Civil,683100,327991,99918,63923,51545,1226477
2019,Electrical,823059,391679,98256,84799,74326,1472119
2023,Mechanical,643168,332455,128522,92070,43057,1239272
2022,Mechanical,850396,362540,144353,54329,31360,1442978
2023,Civil,850481,466002,111188,55322,32048,1515041
2020,Mechanical,628004,364540,135134,83823,69020,1280521
2023,Mechanical,882615,457427,132657,81076,73935,1627710
2021,Mechanical,691820,393041,116088,89875,52482,1343306
2022,Computer Science,791239,444131,94979,88438,55663,1474450
2020,Computer Science,702229,267333,148264,95149,62973,1275948
2023,Mechanical,614568,458308,130106,63833,74446,1341261
2022,Computer Science,609466,377182,81595,68134,45185,1181562
2022,Electrical,822129,478400,112624,57575,49699,1520427
2020,Mechanical,657324,479919,147824,61363,71582,1418012
2023,Electrical,746539,286668,120431,72771,48061,1274470
2022,Civil,675955,261945,97127,78729,41479,1155235
2022,Electrical,747748,352528,97878,85780,73972,1357906
2019,Civil,694791,296526,140690,69812,76607,1278426
2022,Mechanical,762586,297717,136360,94522,74597,1365782
2019,Civil,622650,440498,80207,72847,40892,1257094
2023,Civil,677701,482242,81083,55138,53931,1350095
2023,Electrical,872827,465238,131564,74932,64639,1609200
2023,Electrical,829164,497596,83311,71639,54654,1536364
2021,Electrical,680978,487644,103135,98966,52942,1423665
2023,Mechanical,604860,340480,137109,87159,36934,1206542
2022,Mechanical,734801,469968,141354,95580,59733,1501436
2020,Electrical,631351,459421,143647,96180,49612,1380211
2019,Mechanical,755418,496108,139301,90090,65103,1546020
2021,Mechanical,721449,385673,142233,92577,61855,1403787
2023,Civil,676700,262930,126212,76199,64493,1206534
2023,Civil,835486,254333,137776,87992,39306,1354893
2020,Electrical,869099,452007,131588,76241,68753,1597688
2020,Mechanical,857571,370384,111716,57951,69984,1467606
2021,Civil,792408,267839,101777,63837,46544,1272405
2019,Computer Science,883806,301337,129285,94159,31425,1440012
2023,Mechanical,606408,421276,108788,62688,31733,1230893
2021,Computer Science,771475,270195,84019,59787,75375,1260851
2022,Electrical,863369,408920,126873,84757,40603,1524522
2022,Mechanical,746444,339229,89895,75104,42152,1292824
2021,Electrical,857320,363251,129013,52604,45801,1447989
2023,Electrical,617279,362265,139570,81269,48906,1249289
2021,Electrical,710401,421926,127672,50063,59437,1369499
2023,Electrical,826801,351986,86121,62152,46985,1374045
2020,Electrical,847380,300998,147863,69196,56935,1422372
2021,Mechanical,769259,448462,98930,93781,72515,1482947
2023,Computer Science,847145,281558,129987,86795,51068,1396553
2021,Mechanical,759547,252985,115502,64959,43531,1236524
2021,Mechanical,644552,311794,111688,82869,76753,1227656
2023,Mechanical,799041,293585,87304,81280,64288,1325498
2023,Civil,807606,465886,84049,77924,65158,1500623
2019,Civil,830677,290264,94947,94258,55481,1365627
2021,Mechanical,861869,414398,89495,77467,56226,1499455
2022,Computer Science,805558,334816,104707,66056,31117,1342254
2021,Mechanical,674474,440333,141920,53135,62661,1372523
2021,Electrical,887312,284022,124544,67564,70068,1433510
2023,Civil,632099,396739,110706,88277,72484,1300305
2021,Civil,802252,268065,113993,77462,42459,1304231
2021,Mechanical,840454,364382,94987,52728,51105,1403656
2022,Mechanical,654240,378145,99089,57631,68909,1258014
2023,Computer Science,860746,337191,145997,60884,49464,1454282
2021,Computer Science,852051,391078,89993,74974,62554,1470650
2020,Electrical,701611,321819,91465,99556,70707,1285158
2019,Mechanical,658046,357158,112640,85641,34777,1248262
2022,Mechanical,850468,426148,92366,98259,41432,1508673
2021,Mechanical,616488,449933,109895,86036,44271,1306623
2020,Civil,789913,477391,81785,69078,33801,1451968
2021,Electrical,783741,431465,86242,60274,37057,1398779
2021,Computer Science,741917,253143,104529,68851,56511,1224951
2023,Civil,767131,482413,144399,98526,37510,1529979
2023,Civil,618394,307505,86356,53959,38099,1104313
2023,Civil,776978,393489,103229,73224,45193,1392113
2020,Civil,659332,412372,98220,63894,50011,1283829
2021,Electrical,768377,473134,105651,76965,78900,1503027
2019,Mechanical,642628,278896,141850,87616,50764,1201754
2022,Computer Science,883496,497541,114261,80558,34450,1610306
2023,Computer Science,651993,484051,138479,93945,44549,1413017
2023,Civil,770458,300629,130700,65690,36960,1304437
2021,Civil,608539,408678,122380,83447,46583,1269627
2021,Electrical,732335,289916,107011,67131,36996,1233389
2020,Civil,840310,311330,128603,77429,48567,1406239
2020,Computer Science,806873,257551,98447,67705,44201,1274777
2023,Computer Science,656132,495866,144583,98710,35043,1430334
2021,Mechanical,705494,350972,143056,72246,50420,1322188
2019,Mechanical,825997,369623,92017,95110,70602,1453349
2022,Computer Science,663797,437494,117880,54789,72324,1346284
2021,Computer Science,651798,496924,81355,50533,64620,1345230
2021,Electrical,747722,363216,138936,78776,79031,1407681
2020,Electrical,676421,496917,144608,98302,42629,1458877
2022,Computer Science,869578,317782,127266,68725,58675,1442026
2023,Civil,892172,315391,134554,56694,31662,1430473
2021,Mechanical,666558,354957,138215,55006,44734,1259470
2023,Computer Science,886475,373546,140656,76998,37589,1515264
2021,Civil,667573,375006,134104,87313,73418,1337414
2023,Computer Science,729473,313411,80969,92428,79364,1295645
2022,Mechanical,777398,490509,80254,80087,34655,1462903
2020,Mechanical,866267,323185,90306,87675,38749,1406182
2022,Electrical,878747,496271,145516,74362,40797,1635693
2019,Electrical,642597,487817,148197,54485,61930,1395026
2020,Electrical,794310,381960,98223,51235,36645,1362373
2022,Electrical,822858,488591,147967,93674,41895,1594985
2019,Mechanical,686978,377574,130117,92668,64762,1352099
2021,Civil,879837,438207,81737,98662,77634,1576077
2021,Civil,768769,279424,112476,81983,51432,1294084
2023,Civil,761064,291559,104325,74039,77890,1308877
2020,Computer Science,740594,498782,92326,80416,46858,1458976
2021,Electrical,838078,498290,92911,51145,38233,1518657
2020,Electrical,840140,261075,109080,73804,73611,1357710
2021,Mechanical,743193,403771,102635,97244,62004,1408847
2023,Mechanical,723371,429044,131179,51475,56671,1391740
2022,Computer Science,863761,497824,85213,60047,66760,1573605
2023,Computer Science,643016,259950,137142,62156,58441,1160705
2019,Civil,886420,386485,143545,80421,58233,1555104
2021,Mechanical,830959,289305,107940,77955,67591,1373750
2019,Electrical,786807,253569,128604,72063,66285,1307328
2019,Civil,617959,316778,129119,98444,32268,1194568
2020,Electrical,628522,352633,141604,71799,56220,1250778
2021,Civil,626567,280085,96820,71322,78774,1153568
2019,Electrical,662708,457095,147345,84372,34438,1385958
2022,Computer Science,726206,464917,119314,64932,74269,1449638
2019,Civil,622560,346307,120875,96361,69066,1255169
2022,Electrical,658390,342174,84909,94239,49369,1229081
2020,Electrical,725772,286163,94866,87815,75896,1270512
2019,Mechanical,657805,299592,122789,92964,56603,1229753
2023,Civil,836109,468223,145997,90943,41319,1582591
2020,Electrical,886640,438405,108460,74003,44722,1552230
2022,Mechanical,814373,367431,128500,72501,67757,1450562
2020,Electrical,691257,258039,148769,81092,36028,1215185
2019,Civil,603515,389270,92128,64983,76394,1226290
2021,Computer Science,604454,415426,85202,79768,75093,1259943
2021,Civil,837145,496585,145327,84604,55940,1619601
2022,Civil,622873,253824,127965,72288,61448,1138398
2022,Electrical,875871,300420,111238,96760,38422,1422711
2021,Electrical,728376,339535,129240,56476,73441,1327068
2022,Civil,669070,253436,148837,98837,50688,1220868
2020,Mechanical,724564,343550,134289,82602,76280,1361285
2023,Mechanical,828497,421929,112544,92084,44472,1499526
2023,Mechanical,717213,266057,140064,59962,44900,1228196
2020,Electrical,781051,251310,102413,78439,65671,1278884
2023,Electrical,625465,376913,128899,53400,37763,1222440
2019,Civil,784972,456427,149969,74440,40960,1506768
2020,Computer Science,659799,494841,113033,96697,41084,1405454
2022,Electrical,696129,460065,81378,74610,73043,1385225
2020,Civil,739374,316013,86503,79575,32074,1253539
2021,Civil,843761,310022,122774,69728,37825,1384110
2022,Computer Science,842821,389978,139608,79067,64833,1516307
2021,Mechanical,612875,390940,113617,74303,55205,1246940
2022,Civil,627219,268546,84814,95262,65976,1141817
2023,Civil,898326,348812,138335,92740,34674,1512887
2020,Civil,811613,322855,103763,51628,71862,1361721
2019,Mechanical,606457,283149,90000,89532,76905,1146043
2022,Mechanical,633064,363591,83274,59521,78078,1217528
2022,Computer Science,715256,448453,129868,88513,72013,1454103
2021,Electrical,834659,404756,134232,92519,30122,1496288
2023,Mechanical,809727,279858,94227,75380,51480,1310672
2021,Electrical,760353,295330,97279,78923,39443,1271328
2021,Electrical,858063,489286,144940,84058,34433,1610780
2023,Mechanical,836887,440276,122736,78880,30990,1509769
2019,Civil,834841,342203,89651,68970,35556,1371221
2021,Computer Science,669918,275293,87771,88891,56662,1178535
2021,Electrical,813057,306869,120834,54930,59097,1354787
2022,Civil,689142,340429,83553,85318,77418,1275860
2023,Mechanical,627603,385701,114117,91539,34709,1253669
2020,Electrical,670605,255704,142137,92897,54357,1215700
2019,Electrical,881767,382848,114890,79843,66348,1525696
2019,Electrical,644440,438327,88689,99108,49186,1319750
2023,Civil,889604,298281,108063,82574,63639,1442161
2022,Civil,814117,366972,137198,89751,49208,1457246
2022,Civil,813877,363532,81363,59857,77360,1395989
2023,Electrical,710373,412308,96691,73513,52479,1345364
2022,Electrical,867014,316780,82751,84898,57478,1408921
2019,Computer Science,618909,382405,87782,73593,42922,1205611
2019,Computer Science,871261,450277,92540,72683,57079,1543840
2020,Civil,849975,464192,125991,86508,60766,1587432
2023,Civil,693926,432018,107609,68884,49787,1352224
2021,Mechanical,727463,494955,136655,55307,52537,1466917
2021,Civil,701536,305333,143177,62904,40383,1253333
2020,Computer Science,882272,408349,138396,89535,68318,1586870
2020,Computer Science,851981,431678,96877,67881,61895,1510312
2022,Computer Science,862584,383005,98405,79178,75542,1498714
2020,Electrical,780685,414586,128629,63582,33207,1420689
2020,Electrical,723491,488408,126233,85912,58234,1482278
2021,Civil,750619,339893,101471,92911,60568,1345462
2022,Mechanical,681662,473679,83302,92419,33097,1364159
2020,Mechanical,836128,312958,103511,58025,49022,1359644
2020,Mechanical,600005,387899,85022,99444,74046,1246416
2022,Electrical,834152,280844,123239,91614,64392,1394241
2023,Computer Science,869182,364501,139269,93944,45968,1512864
2022,Computer Science,868558,341200,138398,69188,41149,1458493
2021,Electrical,878626,250792,141895,57604,39717,1368634
2023,Mechanical,829901,420767,149890,89907,46642,1537107
2019,Mechanical,802945,333187,115284,98979,43640,1394035
2022,Civil,633948,292510,128640,77290,46837,1179225
2021,Civil,822873,420209,102453,90596,38990,1475121
2023,Mechanical,822322,363104,117976,56203,34170,1393775
2022,Electrical,620875,465682,93725,57871,54817,1292970
2020,Mechanical,875201,454482,123043,64662,35136,1552524
2022,Civil,632400,463284,144990,86782,31712,1359168
2019,Mechanical,668607,289632,126809,61445,58794,1205287
2022,Electrical,889647,417862,96705,61038,64770,1530022
2023,Computer Science,701096,333568,143131,95840,38151,1311786
2023,Electrical,646612,411957,142456,95822,78438,1375285
2022,Electrical,861538,315214,103089,53505,69022,1402368
2023,Civil,684335,457616,147238,91478,40473,1421140
2020,Electrical,693012,294870,141396,69069,45303,1243650
2022,Electrical,681748,298110,83877,64418,49495,1177648
2020,Civil,762491,359414,111818,66411,51625,1351759
2020,Civil,665195,386243,128555,83033,43761,1306787
2021,Computer Science,804767,390661,122368,59498,38918,1416212
2022,Mechanical,689846,268077,128180,97500,64599,1248202
2023,Electrical,702404,314874,129421,71459,31821,1249979
2020,Civil,861320,453318,106620,72203,64584,1558045
2021,Computer Science,671540,496797,140539,78030,78646,1465552
2022,Mechanical,769361,466844,97077,99962,79243,1512487
2022,Civil,611755,419299,92663,71060,66200,1260977
2019,Mechanical,852915,396009,127285,69774,48353,1494336
2019,Mechanical,684553,259754,131235,96917,78250,1250709
2020,Electrical,734962,275688,97619,83378,48768,1240415
2019,Electrical,856760,257048,149503,95248,66447,1425006
2020,Civil,617175,272568,137477,70930,59184,1157334
2023,Mechanical,825783,347583,107488,63493,79754,1424101
2020,Civil,755360,456091,101169,87795,46811,1447226
2019,Civil,646629,398617,110373,63638,56595,1275852
2023,Mechanical,716779,464021,112669,55724,56032,1405225
2019,Civil,778872,344449,135277,50202,70966,1379766
2020,Mechanical,768439,295217,135120,83169,69031,1350976
2021,Mechanical,682762,429194,146376,52027,47757,1358116
2022,Mechanical,760094,414818,134235,96723,71600,1477470
2019,Mechanical,800401,389781,114229,64807,41954,1411172
2020,Computer Science,657941,377873,95405,78426,59793,1269438
2023,Mechanical,786670,275358,95847,91849,67930,1317654
2019,Electrical,616040,364064,103547,50178,56806,1190635
2019,Electrical,669806,261023,86575,55817,53224,1126445
2022,Electrical,744358,345387,84843,84747,59236,1318571
2020,Mechanical,800211,409828,87739,57185,33811,1388774
2021,Electrical,712076,444247,94852,53984,60368,1365527
2023,Computer Science,655916,435353,131661,72049,66074,1361053
2020,Civil,748672,430361,89157,71405,62719,1402314
2023,Mechanical,865955,439169,98837,60236,38637,1502834
2019,Electrical,631276,457753,94819,71896,42133,1297877
2022,Computer Science,785217,336728,87404,85751,76986,1372086
2022,Civil,801750,428331,94674,64635,58871,1448261
2021,Computer Science,819854,399911,98697,58542,57571,1434575
2022,Electrical,822115,277410,140663,87050,71472,1398710
2019,Computer Science,786757,355696,103570,94378,78653,1419054
2021,Civil,743266,261447,108037,81342,31401,1225493
2020,Electrical,750434,367954,117982,94790,40004,1371164
2022,Civil,646281,336569,148524,57988,63313,1252675
2021,Computer Science,862120,487963,85156,82070,65301,1582610
2019,Mechanical,853693,456737,118280,81955,64777,1575442
2023,Mechanical,778908,345894,140706,62596,58008,1386112
2023,Mechanical,604595,263907,89971,73659,35901,1068033
2019,Mechanical,695930,271637,133140,60416,34085,1195208
2019,Civil,746474,419268,123408,69171,32215,1390536
2023,Mechanical,861745,403441,132022,82577,78809,1558594
2021,Civil,796355,476089,86487,95303,45763,1499997
2023,Electrical,773795,478289,100997,72736,32184,1458001
2019,Mechanical,782394,383661,126456,95271,40354,1428136
2022,Civil,777836,273560,139416,54808,64043,1309663
2020,Mechanical,822360,253034,124767,88656,39504,1328321
2022,Mechanical,881549,381241,108194,55737,33523,1460244
2022,Mechanical,658122,342449,113785,85126,38707,1238189
2019,Civil,830561,253239,138676,79652,51167,1353295
2023,Computer Science,832661,253415,88373,55390,63787,1293626
2021,Mechanical,728909,466560,110283,70600,55871,1432223
2022,Mechanical,865591,326944,135911,50406,53982,1432834
2023,Electrical,784215,384556,106414,82764,31049,1388998
2021,Computer Science,610662,303987,94378,99217,43381,1151625
2022,Civil,658282,268225,84700,82995,32340,1126542
2021,Electrical,890726,330459,144143,95937,72217,1533482
2023,Mechanical,667471,442176,143229,68568,78390,1399834
2020,Electrical,723513,270936,93901,60433,65753,1214536
2023,Electrical,773285,289612,102597,79377,42061,1286932
2019,Mechanical,707578,466018,113428,73184,35705,1395913
2021,Computer Science,683205,345533,115687,98481,54014,1296920
2020,Computer Science,834631,370877,109493,59121,63473,1437595
2021,Electrical,683805,352269,131224,78612,58147,1304057
2021,Mechanical,724698,289952,111852,72207,32484,1231193
2022,Civil,768902,308945,90932,60795,31745,1261319
2019,Electrical,610712,468471,144202,67564,52148,1343097
2021,Civil,726888,255380,113583,98603,46216,1240670
2023,Electrical,832398,431370,127278,91999,62547,1545592
2023,Electrical,796437,467318,109865,51101,71929,1496650
2022,Mechanical,687185,330821,92289,84867,76742,1271904
2019,Mechanical,612210,408332,115521,50513,52012,1238588
2019,Civil,636972,413951,86505,61324,30777,1229529
2023,Civil,836966,397215,124327,65491,39525,1463524
2020,Computer Science,896280,299744,145519,63693,73077,1478313
2022,Mechanical,878089,454021,98409,65923,73348,1569790
2022,Electrical,826273,412650,99517,84600,33114,1456154
2023,Electrical,603052,330262,124533,60872,75173,1193892
2023,Computer Science,889416,307331,110475,93058,65704,1465984
2020,Mechanical,827276,342551,95327,57137,50494,1372785
2020,Electrical,748388,313815,135344,61358,31345,1290250
2019,Computer Science,738312,496998,83671,55807,32041,1406829
2022,Computer Science,616375,321519,130756,98650,44330,1211630
2022,Electrical,625710,400250,124959,76503,43198,1270620
2023,Electrical,780967,342526,108080,64859,70272,1366704
2019,Civil,854624,456929,104544,97905,39747,1553749
2022,Mechanical,746246,441269,98733,72234,47073,1405555
2019,Civil,627597,359365,134211,61079,60286,1242538
2019,Computer Science,685687,286366,120696,80975,58028,1231752
2023,Electrical,718968,434027,128093,54343,56110,1391541
2019,Civil,640274,349830,127042,54628,53440,1225214
2020,Computer Science,803570,487285,133516,72568,62887,1559826
2020,Mechanical,648634,481345,117487,78106,68937,1394509
2021,Electrical,892185,291911,120849,58981,68600,1432526
2023,Civil,887514,333422,94550,84068,77417,1476971
2021,Mechanical,897391,303619,129699,84715,42246,1457670
2020,Civil,806994,425368,148897,52242,57428,1490929
2021,Computer Science,856480,272791,93707,98397,31613,1352988
2023,Mechanical,662982,258301,81924,86424,78343,1167974
2023,Civil,708534,376866,109018,99459,37623,1331500
2019,Mechanical,765546,481730,101031,84218,65801,1498326
2022,Computer Science,886788,353623,145164,90134,35659,1511368
2019,Mechanical,638493,479601,148237,52842,75023,1394196
2023,Civil,842217,362824,129573,66017,59653,1460284
2020,Computer Science,753612,416851,96719,63836,42080,1373098
2020,Electrical,897625,286894,89718,64186,41976,1380399
2019,Civil,826577,479989,80056,84432,73586,1544640
2023,Civil,677097,329618,95352,72757,45718,1220542
2020,Computer Science,884722,430322,127820,97188,39341,1579393
2023,Computer Science,783951,320994,148683,81116,77964,1412708
2020,Electrical,741668,291770,149073,86716,46296,1315523
2023,Civil,779022,272300,80721,70456,56285,1258784
2021,Computer Science,880831,368025,131969,53634,44134,1478593
2023,Electrical,722540,449307,120194,99366,75009,1466416
2023,Electrical,767061,410557,126556,85840,59337,1449351
2019,Computer Science,892327,370605,126775,70856,30455,1491018
2021,Civil,882902,290285,119883,52459,37643,1383172
2022,Mechanical,732154,447627,90911,86474,34620,1391786
2019,Mechanical,838013,367713,145795,81519,38867,1471907
2022,Electrical,696368,413543,100872,67590,55577,1333950
2020,Mechanical,645891,298671,124537,58601,58647,1186347
2022,Mechanical,646901,368216,96860,53469,78894,1244340
2023,Computer Science,671062,270270,110743,74791,55471,1182337
2022,Electrical,752635,469223,122559,87615,35099,1467131
2019,Civil,880118,369870,112205,50348,43887,1456428
2019,Electrical,753460,377897,97645,86419,73314,1388735
2022,Computer Science,680591,394770,130734,52878,78203,1337176
2019,Mechanical,852990,495526,110431,61857,57669,1578473
2019,Civil,880759,484954,140914,87517,30059,1624203
2022,Electrical,622838,322265,97882,94029,42673,1179687
2021,Mechanical,716249,420801,123346,70378,52695,1383469
2021,Electrical,678000,261171,92979,94072,35531,1161753
2020,Civil,744608,460555,124828,50002,32764,1412757
2019,Electrical,736772,310684,87228,75658,31794,1242136
2022,Electrical,769911,436237,118918,73267,40721,1439054
2019,Electrical,872392,299948,90920,95462,35686,1394408
2023,Mechanical,645291,284725,107785,64353,77443,1179597
2019,Civil,815963,269450,105178,51517,59467,1301575
2019,Civil,725612,394372,94052,92855,67755,1374646
2021,Mechanical,617177,375900,129383,69963,42888,1235311
2022,Mechanical,643815,334600,80327,63175,69348,1191265
2019,Mechanical,862170,385513,87038,80367,43533,1458621
2021,Computer Science,704997,361315,88048,67232,51916,1273508
2020,Electrical,660611,400404,94954,87804,33553,1277326
2021,Electrical,687242,270115,137541,99357,38144,1232399
2021,Civil,786175,349405,125471,76468,72042,1409561
2021,Electrical,642082,337404,148315,50520,75207,1253528
2019,Computer Science,747330,423069,93225,71497,55509,1390630
2019,Mechanical,703613,467223,93531,98473,35437,1398277
2020,Civil,695220,394687,89530,76927,54547,1310911
2023,Civil,615389,395804,139035,56258,62518,1269004
2023,Electrical,691860,406439,104791,84902,53830,1341822
2023,Civil,758757,360670,81649,65454,75045,1341575
2020,Mechanical,621797,292738,93472,87606,38749,1134362
2023,Civil,845939,492368,148398,70929,76553,1634187
2023,Mechanical,666332,382053,107134,74177,52349,1282045
2021,Computer Science,836655,443953,146453,50785,59289,1537135
2019,Computer Science,824997,439681,92444,58143,35915,1451180
2019,Mechanical,885840,468162,121121,74092,58695,1607910
2021,Electrical,602024,471927,118217,97818,39734,1329720
2021,Civil,737656,331666,102066,63635,44703,1279726
2021,Electrical,758116,334351,148347,60982,52499,1354295
2019,Civil,857339,389638,116189,63409,51478,1478053
2023,Computer Science,867429,472937,143477,98756,32382,1614981
2021,Computer Science,869514,452957,115489,68541,60128,1566629
2020,Computer Science,617903,499657,107284,53528,55583,1333955
2021,Civil,763571,260728,104698,86327,72241,1287565
2022,Computer Science,885139,355852,123660,96888,67126,1528665
2021,Computer Science,688377,333911,99637,74518,71080,1267523
2019,Computer Science,801474,367616,128024,74946,76799,1448859
2021,Computer Science,899966,468422,140405,82080,58692,1649565
2022,Electrical,709366,286214,141305,85705,62907,1285497
2020,Computer Science,663853,439007,113556,74556,37644,1328616
2023,Computer Science,785715,468153,149561,90906,64583,1558918
2021,Electrical,753405,295588,83654,87909,67069,1287625
2022,Electrical,652442,400025,120428,99873,75098,1347866
2022,Civil,830755,318408,118036,71775,45185,1384159
2020,Mechanical,609675,455976,124549,74041,70053,1334294
2019,Computer Science,689590,284103,145355,50835,71988,1241871
2021,Computer Science,893805,320949,142119,85747,40446,1483066
2022,Computer Science,664289,475877,126257,93285,53162,1412870
2020,Civil,617184,430336,95987,94884,44150,1282541
2023,Computer Science,756894,401228,100810,85192,71304,1415428
2022,Mechanical,807537,263423,100311,97335,59837,1328443
2020,Electrical,867411,288062,134478,66104,66003,1422058
2019,Civil,783719,423877,114920,64927,31387,1418830
2019,Electrical,898169,251987,88738,54521,42209,1335624
2022,Computer Science,721246,312979,142232,94086,30983,1301526
2022,Computer Science,732053,287597,85474,64280,77114,1246518
2021,Computer Science,749544,333905,139026,97544,62151,1382170
2020,Mechanical,750408,408940,146024,80753,51803,1437928
2022,Mechanical,756659,326970,130974,97948,49378,1361929
2021,Civil,837439,313805,104144,99605,37548,1392541
2021,Electrical,609665,369779,85622,53459,69621,1188146
2022,Computer Science,758169,461156,132273,79435,30775,1461808
2019,Computer Science,652474,397708,119214,78077,51365,1298838
2020,Computer Science,803045,307467,137993,51148,60707,1360360
2020,Computer Science,675911,478991,105223,99674,79887,1439686
2019,Mechanical,692643,357732,101865,87345,54137,1293722
2022,Electrical,892628,398079,143649,81036,51531,1566923
2020,Electrical,859383,351460,123026,99273,47870,1481012
2022,Civil,776682,476819,139207,70002,79547,1542257
2022,Mechanical,781879,457936,106866,98440,75738,1520859
2021,Computer Science,887979,384461,92416,89398,32001,1486255
2019,Electrical,826351,368105,105775,86490,74407,1461128
2022,Electrical,696453,374535,109080,55930,44756,1280754
2023,Mechanical,653790,259458,99374,63388,70830,1146840
2019,Civil,808032,318481,138451,69691,57863,1392518
2020,Civil,871787,324888,132599,53642,40046,1422962
2021,Computer Science,613200,326022,95684,69201,53652,1157759
2020,Civil,652275,422472,104002,57421,66956,1303126
2020,Electrical,752363,317628,102972,89815,43886,1306664
2019,Civil,691685,432929,146153,63554,50745,1385066
2020,Computer Science,872763,445439,126404,55588,69117,1569311
2022,Electrical,705454,417599,86309,73771,61823,1344956
2020,Civil,601766,320648,148326,75824,68948,1215512
2021,Civil,865693,266937,87826,98028,43322,1361806
2021,Mechanical,749765,418744,92134,59316,37794,1357753
2023,Computer Science,856356,492634,99693,92617,76169,1617469
2021,Civil,820172,251112,84054,92713,79895,1327946
2020,Mechanical,625301,416617,96090,95562,36162,1269732
2021,Electrical,644763,478348,95569,78234,78691,1375605
2019,Mechanical,751837,470089,112227,69786,46757,1450696
2021,Mechanical,607425,298355,86508,87100,35905,1115293
2022,Civil,875001,325561,96608,65329,58765,1421264
2019,Civil,783843,415154,104520,65698,75044,1444259
2023,Civil,859561,368181,110932,75327,68457,1482458
2022,Mechanical,641457,310482,99734,97609,49404,1198686
2020,Electrical,810813,329098,149363,66548,45380,1401202
2020,Computer Science,605452,392376,130555,89757,45508,1263648
2020,Mechanical,711153,372978,96257,68340,49676,1298404
2022,Civil,792543,306625,112194,53860,53260,1318482
2022,Computer Science,880444,453623,96793,69159,36897,1536916
2022,Electrical,601845,425957,114684,77865,31564,1251915
2019,Computer Science,719342,374359,133219,84536,79102,1390558
2019,Civil,837366,321246,82859,81755,43870,1367096
2020,Mechanical,839004,262588,119840,63743,44219,1329394
2021,Mechanical,794110,365910,139327,56226,46441,1402014
2020,Civil,848850,378658,114819,62718,49880,1454925
2023,Mechanical,814362,270967,121704,94656,40379,1342068
2019,Civil,847688,380153,146137,89389,32948,1496315
2022,Mechanical,634404,468512,140379,99934,59593,1402822
2019,Mechanical,622564,274256,104318,75530,65902,1142570
2022,Mechanical,697898,439420,143956,82908,47971,1412153
2023,Electrical,880371,406124,85274,99871,38969,1510609
2023,Electrical,695259,378121,98226,51650,50646,1273902
2019,Civil,724451,462044,123634,90653,33678,1434460
2022,Electrical,617215,468423,144501,97032,73508,1400679
2023,Civil,730577,439551,99046,83783,57519,1410476
2020,Computer Science,858392,330732,101910,97458,33343,1421835
2020,Computer Science,671074,441272,91503,91302,34014,1329165
2022,Electrical,708621,464697,128392,56292,35107,1393109
2019,Computer Science,779289,496277,141472,72737,74638,1564413
2023,Computer Science,706759,464212,125335,75551,67096,1438953
2019,Mechanical,728471,380145,102487,93543,67423,1372069
2020,Mechanical,883855,383578,116593,69504,68626,1522156
2023,Civil,648398,348120,89874,66371,68388,1221151
2019,Computer Science,863430,401781,134822,70810,71880,1542723
2021,Civil,765369,439607,133948,79036,62332,1480292
2022,Civil,708304,294840,83608,99162,69772,1255686
2022,Computer Science,704959,495512,134501,65547,64010,1464529
2021,Electrical,839317,362647,133912,77203,53399,1466478
2020,Computer Science,757557,441659,107546,59305,79232,1445299
2023,Mechanical,729745,309321,148203,58813,32661,1278743
2022,Computer Science,654583,484855,142496,50900,34798,1367632
2021,Electrical,724077,293202,135186,53747,30540,1236752
2021,Civil,711359,437660,122346,95024,52329,1418718
2020,Civil,627086,384162,85230,73245,55850,1225573
2020,Mechanical,747556,485873,105720,53103,49169,1441421
2019,Mechanical,799695,309231,123023,91286,33157,1356392
2022,Mechanical,704132,271552,117602,50073,67485,1210844
2019,Civil,659263,475743,147082,99402,35336,1416826
2021,Mechanical,749747,461299,95050,52497,37165,1395758
2023,Computer Science,660664,486369,131315,79577,57618,1415543
2023,Civil,777198,414813,132164,71012,72280,1467467
2020,Electrical,842730,271661,110134,58487,77496,1360508
2023,Civil,667804,422097,95640,99449,43754,1328744
2023,Computer Science,890232,387164,141671,80023,35209,1534299
2023,Computer Science,811087,416746,94284,74877,44490,1441484
2021,Mechanical,687893,381642,140526,95567,57601,1363229
2023,Civil,868113,393156,83423,56517,37645,1438854
2023,Civil,608981,315843,108577,94584,68508,1196493
2023,Civil,707154,441824,138900,96173,66922,1450973
2019,Electrical,886552,319278,147868,91012,65433,1510143
2021,Mechanical,755313,488350,86066,55615,36018,1421362
2020,Computer Science,782177,344328,137888,60468,56374,1381235
2019,Computer Science,792122,381837,88583,60879,35713,1359134
2022,Mechanical,603657,376355,118057,81955,75839,1255863
2021,Computer Science,883374,488340,102604,63078,60072,1597468
2021,Computer Science,813766,274198,106564,54590,51535,1300653
2022,Mechanical,684731,311201,141429,60910,61320,1259591
2022,Computer Science,773412,323271,108941,94895,57563,1358082
2022,Civil,767022,462810,135511,81976,78095,1525414
2020,Electrical,738939,428271,117962,71574,48962,1405708
2023,Mechanical,809614,392449,118573,90652,31026,1442314
2021,Electrical,604329,361578,105692,72716,34473,1178788
2023,Computer Science,898009,460905,138420,83430,34667,1615431
2023,Computer Science,798012,389108,115763,58199,57889,1418971
2022,Civil,637869,290364,125680,83436,56140,1193489
2020,Mechanical,797977,365227,86393,77740,46970,1374307
2019,Computer Science,683984,470977,113488,59477,45941,1373867
2020,Mechanical,701069,350353,101459,50160,59028,1262069
2023,Mechanical,848577,499043,92554,93358,63452,1596984
2020,Mechanical,718728,418515,117867,94205,52426,1401741
2022,Mechanical,625801,382735,125015,56460,33268,1223279
2019,Mechanical,818359,420316,85057,66401,45193,1435326
2022,Electrical,835637,439463,85305,85301,58066,1503772
2019,Civil,690709,327564,141276,72894,30658,1263101
2023,Mechanical,855560,466431,112740,87214,64064,1586009
2019,Electrical,843738,396149,104118,95927,64293,1504225
2019,Computer Science,807831,438921,86674,88322,73042,1494790
2019,Mechanical,616220,355447,122331,98036,69918,1261952
2020,Computer Science,875536,269631,95316,93277,37792,1371552
2020,Mechanical,882154,433724,96217,52918,36604,1501617
2023,Electrical,726951,448518,147541,96147,77821,1496978
2019,Electrical,748306,283500,94602,75629,68557,1270594
2021,Electrical,715795,400969,93987,66699,37420,1314870
2023,Civil,725223,308915,129915,96900,68521,1329474
2019,Computer Science,675205,418449,93543,57069,78312,1322578
2019,Civil,601082,457742,107944,91279,53018,1311065
2020,Mechanical,758566,352760,138241,89190,35108,1373865
2023,Computer Science,636719,276897,89144,54527,57150,1114437
2019,Electrical,648737,428352,118459,69099,35247,1299894
2019,Computer Science,707271,351639,119827,65622,38401,1282760
2023,Electrical,770608,363849,110741,76281,47007,1368486
2021,Civil,781676,361118,149734,89433,39997,1421958
2023,Civil,667839,307320,149741,89875,35261,1250036
2023,Electrical,782075,453664,149177,65531,34268,1484715
2021,Electrical,687745,475558,83543,55132,35984,1337962
2023,Mechanical,726298,318289,85591,79396,50926,1260500
2019,Civil,693709,281941,136395,93239,61862,1267146
2023,Civil,821798,480748,140434,91430,62458,1596868
2021,Mechanical,707252,395306,109055,77807,30010,1319430
2022,Civil,772855,325172,86116,89550,47144,1320837
2023,Electrical,814838,253376,135485,77196,55903,1336798
2020,Computer Science,820013,280783,146297,65993,31177,1344263
2019,Computer Science,874947,422321,82407,75958,56946,1512579
2019,Civil,780697,293025,111594,97358,39168,1321842
2020,Mechanical,718819,266447,146421,89513,32389,1253589
2020,Electrical,613698,466937,115411,88402,36364,1320812
2023,Computer Science,615376,266713,135444,95335,57033,1169901
2020,Electrical,875261,378869,106238,89028,78545,1527941
2022,Civil,836591,254858,121703,64945,41865,1319962
2021,Civil,648786,432187,115196,67569,48936,1312674
2020,Computer Science,713005,466080,92738,73379,42327,1387529
2020,Civil,818850,309834,95772,88877,62252,1375585
2022,Mechanical,762767,332060,145270,72825,65078,1378000
2019,Civil,692529,492995,103492,50915,33741,1373672
2019,Civil,841496,385611,134979,73848,70053,1505987
2023,Civil,700919,445055,130338,63669,54001,1393982
2022,Electrical,798382,399929,144551,59875,33839,1436576
2021,Electrical,809870,353898,116855,64853,70349,1415825
2021,Computer Science,669407,352207,86228,52425,49139,1209406
2022,Computer Science,673809,386436,148367,82440,76905,1367957
2021,Computer Science,879373,447057,100045,83193,55398,1565066
2019,Civil,642176,440241,104318,84555,55036,1326326
2021,Electrical,694825,336366,138458,85352,68005,1323006
2021,Mechanical,697555,402150,93795,87416,75272,1356188
2022,Civil,603145,418646,134524,66552,31740,1254607
2022,Civil,697289,250869,101747,83282,48508,1181695
2021,Civil,738874,485455,127373,86203,61611,1499516
2020,Mechanical,864407,312624,111560,87293,35291,1411175
2022,Computer Science,657788,421147,91282,69000,61109,1300326
2023,Mechanical,739227,343676,113831,80802,49481,1327017
2023,Computer Science,731994,253659,143073,60569,35247,1224542
2019,Mechanical,803303,417442,103043,75266,71613,1470667
2021,Electrical,751744,356888,145322,53204,51383,1358541
2020,Civil,769598,308185,132900,57765,74501,1342949
2019,Civil,673352,367136,100929,60696,55319,1257432
2021,Civil,826710,460993,115500,74928,69334,1547465
2022,Computer Science,769770,424823,81872,98910,53728,1429103
2023,Mechanical,885528,312758,117488,64679,63620,1444073
2020,Electrical,603512,465945,147505,83885,60442,1361289
2023,Mechanical,762572,386203,105460,84173,51310,1389718
2022,Civil,723775,382430,92155,94899,72521,1365780
2021,Electrical,678743,341150,91870,97865,51452,1261080
2022,Electrical,679858,438443,83717,88182,42137,1332337
2022,Civil,654800,463379,81374,89109,73636,1362298
2023,Mechanical,700364,460211,101826,54174,44905,1361480
2020,Civil,864531,397318,93427,67061,51773,1474110
2022,Mechanical,787232,267216,144442,91510,60024,1350424
2023,Electrical,804639,291209,114708,75395,47702,1333653
2020,Electrical,732871,292987,104271,50213,46505,1226847
2021,Civil,719095,358024,143572,84434,34254,1339379
2021,Electrical,635548,401649,96631,63276,79007,1276111
2019,Computer Science,690450,497598,99887,59085,38498,1385518
2023,Electrical,705669,292320,105259,95036,42174,1240458
2020,Computer Science,673071,261301,137987,78481,59422,1210262
2022,Electrical,712808,456123,129630,81276,59733,1439570
2021,Civil,678591,473410,99144,74597,31896,1357638
2020,Civil,824213,376560,129060,72244,75646,1477723
2023,Computer Science,866441,250891,135092,80601,68744,1401769
2019,Civil,709513,403044,100836,84029,33911,1331333
2021,Electrical,698752,300457,146904,71264,79105,1296482
2020,Electrical,736080,363389,124456,63890,38340,1326155
2020,Civil,817885,435507,116380,96312,47423,1513507
2020,Electrical,747892,270932,91569,92852,72350,1275595
2023,Mechanical,753325,254192,111182,97907,66672,1283278
2023,Mechanical,667156,266128,101649,71058,34876,1140867
2023,Electrical,842960,272836,107003,66121,71077,1359997
2022,Civil,660263,274837,96551,87964,30703,1150318
2020,Computer Science,699252,367028,103826,87352,68238,1325696
2021,Civil,718632,366481,104729,55021,36440,1281303
2023,Computer Science,616575,375176,131696,72614,61937,1257998
2023,Civil,874348,375172,83868,92950,32024,1458362
2020,Electrical,611952,272778,121274,95277,45751,1147032
2023,Mechanical,683323,293130,118718,93420,42730,1231321
2022,Civil,782214,266708,112353,52631,51380,1265286
2022,Computer Science,764944,357481,121682,56345,58972,1359424
2023,Mechanical,760448,405304,110653,90864,67113,1434382
2020,Computer Science,797156,438338,94141,97674,40149,1467458
2020,Electrical,742712,420484,91537,76844,68402,1399979
2020,Mechanical,888581,254782,110401,56300,47381,1357445
2019,Computer Science,727129,442268,107387,88612,79557,1444953
2023,Civil,854522,407387,86630,68560,62359,1479458
2020,Electrical,607903,260052,123461,55362,73808,1120586
2022,Electrical,814776,269521,124293,58097,30243,1296930
2021,Electrical,626863,450506,103070,55599,32414,1268452
2021,Civil,890692,463827,93416,75452,33856,1557243
2020,Civil,611467,319690,88629,97373,36263,1153422
2021,Mechanical,886045,285546,143444,54258,77953,1447246
2021,Civil,885445,460417,88360,75530,45799,1555551
2019,Mechanical,833614,407044,92011,56640,71392,1460701
2022,Electrical,669903,354713,120721,87056,42470,1274863
2022,Mechanical,619755,459131,116069,67261,43772,1305988
2019,Computer Science,864237,445457,133270,87827,57382,1588173
2019,Electrical,856094,352617,91227,65141,63909,1428988
2021,Electrical,885084,272030,119587,76752,34126,1387579
2023,Mechanical,775112,421448,141720,73548,49408,1461236
2021,Electrical,728714,466713,124550,85368,44863,1450208
2019,Civil,691544,493093,148305,65902,43584,1442428
2022,Computer Science,684437,339831,133651,77683,53391,1288993
2021,Mechanical,707001,327400,131332,68792,49840,1284365
2023,Mechanical,687725,490590,148881,87628,66965,1481789
2021,Electrical,710675,459484,148201,92933,55671,1466964
2020,Civil,694266,268055,104807,52334,68592,1188054
2021,Electrical,871380,480292,123552,50767,42097,1568088
2019,Electrical,815196,468580,137300,81644,48839,1551559
2022,Mechanical,734974,406565,106951,76992,74883,1400365
2022,Electrical,699656,324861,100264,79570,47774,1252125
2019,Computer Science,896508,371184,99121,61737,67693,1496243
2020,Electrical,707071,366524,130539,63372,79769,1347275
2019,Electrical,751168,366826,110311,76885,32469,1337659
2021,Mechanical,743092,286775,122397,70590,42468,1265322
2019,Electrical,658473,432129,99749,89853,65470,1345674
2019,Civil,841472,335909,109218,50744,69025,1406368
2020,Mechanical,772349,286253,131591,77158,70873,1338224
2021,Electrical,615675,467789,124133,70558,33165,1311320
2023,Computer Science,718384,301884,124867,82259,41370,1268764
2023,Computer Science,678229,326497,81316,71450,73251,1230743
2022,Mechanical,689049,267705,117972,86929,77526,1239181
2019,Mechanical,783220,425748,146220,96589,67198,1518975
2022,Electrical,820319,482730,122635,59586,72006,1557276
2020,Civil,705711,341640,131265,50286,68760,1297662
2023,Electrical,710090,460117,130109,53247,58942,1412505
2019,Computer Science,801974,257101,128797,81974,75017,1344863
2020,Civil,888609,312495,88079,93562,62209,1444954
2020,Civil,894430,385815,140887,55099,69365,1545596
2019,Civil,654795,258951,102412,66387,31407,1113952
2020,Electrical,810255,388086,115862,98829,55976,1469008
2019,Computer Science,703845,286180,94821,72319,71969,1229134
2019,Mechanical,872889,306977,113655,50411,68325,1412257
2021,Electrical,854232,497117,124688,70729,45515,1592281
2022,Mechanical,853730,440606,134576,70111,66174,1565197
2020,Civil,803426,313209,132236,96566,41794,1387231
2020,Civil,829333,499241,125221,65704,35700,1555199
2021,Electrical,648566,422980,146092,60109,38127,1315874
2021,Computer Science,674974,358575,134445,51356,57391,1276741
2021,Civil,770951,300918,88900,81172,40740,1282681
2023,Mechanical,848595,389291,113485,58349,31545,1441265
2023,Mechanical,704417,388235,93891,67984,53691,1308218
2023,Electrical,779729,383542,95014,77460,46518,1382263
2019,Mechanical,739570,490106,117964,88474,65627,1501741
2020,Computer Science,804739,397615,131171,94449,58054,1486028
2022,Civil,887251,400348,124739,57196,43057,1512591
2019,Mechanical,759865,370014,123374,71457,36003,1360713
2020,Mechanical,689241,417953,119459,63549,64032,1354234
2020,Civil,623397,328950,87045,99304,48156,1186852
2021,Electrical,607704,257749,123255,59821,79316,1127845
2021,Mechanical,878586,274182,131965,85564,75380,1445677
2019,Electrical,794860,327450,81237,61073,78787,1343407
2021,Electrical,729576,330543,132195,57282,78345,1327941
2020,Mechanical,609765,346487,116326,89719,57563,1219860
2021,Computer Science,610002,360227,85293,69189,71579,1196290
2023,Electrical,859853,479216,105274,86848,36725,1567916
2021,Mechanical,873534,402455,99237,94430,51682,1521338
2020,Electrical,775508,328578,98229,59247,57727,1319289
2019,Civil,858446,366258,136718,60771,69582,1491775
2022,Computer Science,845620,406484,148718,93725,46185,1540732
2021,Computer Science,606641,263181,129615,72234,66740,1138411
2020,Civil,711119,294898,81915,73746,37594,1199272
2022,Civil,877768,440702,132774,84096,79554,1614894
2022,Electrical,609966,253405,87076,62236,37199,1049882
2023,Civil,820422,477476,113083,85921,69032,1565934
2022,Computer Science,765261,260862,133918,74576,57350,1291967
2020,Civil,671301,435751,84793,50166,45874,1287885
2020,Mechanical,715123,278688,130528,64652,34480,1223471
2021,Mechanical,834624,298017,146798,69638,60435,1409512
2021,Electrical,604959,477553,89319,71444,60120,1303395
2021,Computer Science,724125,262939,93194,65233,36619,1182110
2022,Mechanical,627215,493343,99309,51885,32607,1304359
2022,Civil,655046,475539,138396,80364,39382,1388727
2023,Mechanical,833265,354152,106998,64708,38580,1397703
2021,Mechanical,769741,289585,83468,90297,49788,1282879
2019,Electrical,767198,366315,92651,83667,52026,1361857
2023,Civil,720333,354447,100405,85016,47173,1307374
2019,Civil,616772,493885,94482,94223,53280,1352642
2022,Civil,651943,489434,84409,53412,64262,1343460
2023,Electrical,753290,487772,146083,61769,77156,1526070
2023,Civil,701124,404014,103426,65947,36710,1311221
2020,Civil,736031,491147,134757,93147,63588,1518670
2022,Mechanical,814051,386344,94436,56449,42228,1393508
2022,Mechanical,625874,425206,96490,92179,56055,1295804
2023,Civil,731007,405337,132136,85900,61152,1415532
2022,Computer Science,601301,429264,108962,90923,50449,1280899
2023,Computer Science,643319,409740,109288,58136,57706,1278189
